аж: аж
актуальный: актуальна
ангар: ангар
аптека: аптеке
арес: арес
боевой: боевые боевых
быстро: быстро
быстрый: быстрее
быть: будут
вакансия: вакансии
ваш: ваш
версия: версию
весенний: весенний
взглянуть: взгляните
визуальный: визуального
включать: включает
внешне: внешне
всё: всё
второе: второе
вшестером: вшестером
вы: вами
выйти: вышло
геймер: геймеров
глава: главу
год: год
давать: давайте
делать: делает
день: дня
дзен: дзен
дзеневакансиидзен: дзеневакансиидзен
длинный: длинной
добавить: добавлен добавлена добавлено
дозарядка: дозарядки
документ: документы
дополнение: дополнение
дополнительный: дополнительные
доступный: доступен
другой: другое
ждать: ждать
задание: задания
задача: задач задачи
заряжаться: заряжается
земля: земли
знакомый: знакомого
ивента: ивент
игра: игр игра игре игры
игровой: игровой
игрок: игроки
известный: известны
индустрииигра: индустрииигры
иной: иными
интересуютсяследить: интересуютсяследить
информация: информация
исключение: исключением
источник: источник
итак: итак
каждый: каждую каждый
канал: канал
комментарий: комментарий
комментироватьпока: комментироватьпока
консолиновинка: консолиновинки
контакт: контакты
который: которое котором который
лавка: лавки
любить: люблю
максимально: максимально
марс: марс марса
материал: материале
машина: машина
месяц: месяцев
механизм: механизм механизмом
минв: минв
минута: минуты
мир: мир мире
млн: млн
многое: многое
награда: награды
назадподписаться: назадподписаться
назадподписатьсяобзор: назадподписатьсяобзор
назадподписатьсястать: назадподписатьсястали
название: названием
найти: найти
насколько: насколько
настольный: настольная настольной
нация: нация
невозможный: невозможного
неделя: неделя
недостаткиприветствовать: недостаткиприветствую
нечего: нечего
новый: новая новые
обновить: обновленную
обновление: обновление обновлении
оснастить: оснащён
основание: основание
основной: основной
особенно: особенно
особо: особо
отличаться: отличается
очень: очень
первый: первым
первымрекомендовать: первымрекомендуем
победа: победе
повестка: повестке
подписчиковподписатьсябыть: подписчиковподписатьсябыл
подробный: подробнее
поехать: поехали
пожалуйста: пожалуйста
позволять: позволяющее
показать: показали
покорение: покорение
полностью: полностью
получить: получите получить
появиться: появилась появились
представить: представлен
предшественник: предшественнику
предыдущий: предыдущего
преимущество: преимущества
прерываться: прерывается
прислать: присланных
продемонстрировать: продемонстрировали
продолжать: продолжаем
пройти: пройдя
пропустить: пропустите пропустить
прочитать: прочитать
публикациина: публикациине
путь: путь
различный: различные
разобраться: разберёмся
рамка: рамках
рандома: рандоме
ранее: ранее
рассказывать: рассказывать
рассмотреть: рассмотрим
расцветка: расцветку
ребята: ребятами
режим: режимы
ритуал: ритуал
свой: своему
сегодня: сегодня
скриншот: скриншоты
следующий: следующий
слово: словами
смочь: смогут
снаряд: снаряд снаряда снарядом
событие: событие событии события
современный: современном
соответствовать: соответствует
спасибо: спасибо
специальный: специальную
стать: станет
статья: статья
стиль: стиля
стрельба: стрельбе
строго: строго
сыграть: сыграло
танк: танк танка танков
танкист: танкисты
танковгеймингнайти: танковгеймингнайти
темувидеостатьироликиновостивидеоигрыдетямвсё: темувидеостатьироликиновостивидеоигрыдетямвсё
темувойтиглавнаяподпискинайти: темувойтиглавнаяподпискинайти
темымиро: темымир
терраформировать: терраформировать
тихонаписать: тихонапишите
три: трёх
тыс: тыс
уникальный: уникальный уникальным
фишка: фишки
функционал: функционалу
хотеть: хотите
читать: читали
шестеро: шестеро
эксклюзивный: эксклюзивный
экспедиция: экспедиция
это: это
этот: эта
эффективный: эффективным
