автопилот: автопилоте
аксессуар: аксессуары
архитектура: архитектурой
бесплатный: бесплатный
бизнес: бизнес
битва: битву
близкий: ближайшей
будущее: будущее
будущий: будущей
быть: будут
важный: важную
вакансия: вакансии
вермишель: вермишель
версия: версию
весь: вся
взглянуть: взглянем взгляните
взламывать: взламывать
взлом: взлома
видео: видео
видеоигра: видеоигр видеоигры
видеокарта: видеокарта
видеопамять: видеопамяти видеопамять
визуальный: визуальных
включать: включает
включить: включить
владелец: владельцу
вместе: вместе
возникать: возникает
войти: войти
время: времени
вручную: вручную
всё: всё
выйти: вышел вышло
высокий: высокой
выходить: выходит
гаджет: гаджеты
гб: гб
гейминг: гейминг
геймплей: геймплей
гипервизора: гипервизор гипервизора
главный: главная главными
год: год года лет
горячий: горячую
готовый: готовы
графический: графический графических графическую
давать: давайте
два: две двумя
действительно: действительно
дело: деле
день: день дня
дзен: дзен дзене
документ: документы
должный: должном
домашний: домашних
дорога: дороги
достаточный: достаточном
драйвер: драйверами
ещё: ещё
ждать: ждет
железо: железа
загрузка: загрузке
задача: задачи
запуск: запуска
запускать: запускать
запустить: запустить
захватывать: захватывающими
защита: защиты
заяц: зайцами
звёздочка: звездочкой
игра: игр играми игры
играть: играет
игровой: игровой игровые игровым
известно: известно
измышление: измышления
изображение: изображением изображения
иметь: имеет
индустрия: индустрии
интересный: интересных
интересоваться: интересуются
информация: информация
исполняемый: исполняемый
использование: использование использования
использовать: использовать использует
исследователь: исследователей исследователи
источник: источник
каждый: каждый
канал: канал
карта: карт карту
киберспорт: киберспорт
китайский: китайский
ключевой: ключевых
код: код кода
количество: количестве
комплектующие: комплектующие
компонент: компонентов
компьютер: компьютеры
компьютерный: компьютерных
консоль: консоли консоль
контакт: контакты
который: которая который
краткий: кратким
крупный: крупное крупных
кулинарный: кулинарные
ландшафт: ландшафт
логический: логические
любой: любые любых
магазин: магазин
макароны: макароны
маркет: маркет
мгц: мгц
место: месте
месяц: месяцев
метод: метод
мина: мин
минута: минут минуты
мир: мир мире
млн: млн
многопользовательский: многопользовательские
мобильный: мобильные
монстр: монстры
мощный: мощную
надёжный: надёжен
назад: назад
найти: найти
насколько: насколько
наслаждаться: наслаждаться
научиться: научились
неделя: недели неделю
некоторый: некоторого некоторые
необходимость: необходимость
неподписанный: неподписанного
новинка: новинки
новость: новостей новости
новый: новейшими нового новые новый
нужно: нужно
обеспечить: обеспечить
обнаружить: обнаружили
обновление: обновление
оборудование: оборудование
обход: обход
ограничение: ограничения
один: одним одного
одиночный: одиночные
однако: однако
опубликовать: опубликован
оснастить: оснащенную
отвечать: отвечает
отзыв: отзыву
открывать: открывать
отличие: отличие
панель: панели
первый: первое
передаваться: передаваться
персональный: персональные
перспектива: перспективе
плавно: плавно
плавный: плавный
победитель: победителем
погнаться: погонишься
поддерживать: поддерживать
подписаться: подписаться подпишитесь
подписка: подписки
подписчик: подписчиков
подразделение: подразделением
подтвердить: подтвердили
позволять: позволяющий
поймать: поймаешь
пользователь: пользователь пользователю
пользовательский: пользовательские
пользоваться: пользуются
помочь: поможет
помощь: помощью
популярность: популярностью
поскольку: поскольку
последний: последнюю
постоянно: постоянно
поток: потока
потрясать: потрясающих
почитать: почитать
предисловие: предисловие
предназначить: предназначена
представлять: представляет
прийтись: придётся
приложение: приложений приложения
пробный: пробную
программный: программный
прогресс: прогрессом
пропатчить: пропатчить
пропустить: пропустите пропустить
просто: просто
протаранить: протаранила
протестировать: протестировал
против: против
процессор: процессор процессоров
публикация: публикации
пустой: пустой
пытливый: пытливые
развивающийся: развивающийся
разгромить: разгромить
разместить: размещён
разрешение: разрешении
рассмотреть: рассмотрим
реализация: реализации
ребёнок: детям
редактор: редактор
рейтинг: рейтинги
рекомендовать: рекомендуем
репозиторий: репозитории
ролевый: ролевые
ролик: ролики
роль: роль
рост: роста
руководство: руководством
рынок: рынка
сайт: сайте
сам: самом
самый: самыми
связанный: связанных
себя: собой
сегодня: сегодня
сегодняшний: сегодняшний
семь: семь
система: системе
сказать: сказали
следить: следить
слово: словам
слух: слухи
смочь: сможет
снабдить: снабжён
собственный: собственный
современный: современных
согласно: согласно
соединить: соединенных
создание: создание
спагетти: спагетти
специалист: специалист
способ: способ
способный: способна
сравнение: сравнение
стать: станут
статья: статьи
стена: стену
стоять: стоят
стратегия: стратегии
существовать: существуют
тактовый: тактовую
тема: темой тему темы
терпение: терпения
технический: технические
технология: технологии
требовать: требует
тыс: тыс
узнать: узнаем
указывать: указывают
ум: умы
управление: управления
уровень: уровне
утверждать: утверждают
утверждение: утверждению
утилит: утилиты
файл: файл
финансы: финансы
фузилля: фузилли
хакерский: хакерские
характеристика: характеристики
хватить: хватит
хотеть: хочет
частота: частоту
читать: читали
чётко: четко
шоу: шоу
штат: штатах
экономика: экономика
эксплойт: эксплойт эксплойта
эксплойтов: эксплойтов
экшн: экшн
электроника: электроника
эмулятор: эмуляторы
это: это
эффект: эффектов эффекты
являться: является
яндекс: яндекс
