автор: авторов
активно: активно
аналог: аналогом
аниме: аниме
аудитория: аудиторию
близкий: ближайшие
боевой: боевой
боевок: боевок
божественность: божественность
божественный: божественная
бороться: борется
будущий: будущих
вакансия: вакансии вакансиях
вариация: вариации
вдохновиться: вдохновилось
ведьмак: ведьмак
вера: верой
вероятно: вероятно
весь: всему
взглянуть: взгляните
видео: видео
видеоигра: видеоигры
видюхий: видюха
визуальный: визуальных
внимание: внимания
войти: войти
впечатлять: впечатляет
враг: врага
время: времени время
вряд: вряд
вселенная: вселенной
вспоминать: вспоминаем
всё: всё
выживач: выживач
выйти: выйдут
выпустить: выпустивших
выход: выхода
гач: гача
геймер: геймера
гейминг: гейминг
геройский: геройский
главный: главная
год: год года году годы лет
город: городе
городской: городская городскую
графика: графикой
данные: данным
данный: данном
действие: действие действия
декабрь: декабре
день: дня
дзен: дзен дзене
дикий: дикая
документ: документы
должный: должен должна
достигнутый: достигнутом
другой: другие
думать: думал
ещё: ещё
жанр: жанрами жанры
желание: желания
жизнь: жизни
занятый: заняты
захватчик: захватчиком
зваться: зовется
зря: зря
игра: игр игра игре игрой игру игры
игрок: игрокам
идея: идеи
известный: известная
изометрический: изометрическая
иной: иных
инопланетный: инопланетным
инсайдер: инсайдеры
интересоваться: интересуются
использование: использованием
использоваться: используется
ия: ии
каменный: каменные
канал: канал
канон: канона
классика: классика классику
классический: классические
командовать: командуете
комп: комп
компания: компания
компьютер: компьютером
конец: конца
контакт: контакты
концепция: концепцией
копировать: копировал
корректный: корректного корректный
космический: космический космической
космос: космосе
который: которая которой котором которую которые который
кровь: крови
линейка: линейка
линия: линий
маленький: меньше
материал: материале материалов
менее: менее
месяц: месяца
механика: механики
меч: меч
мина: мин
минута: минут минуты
мир: миром
миядзак: миядзаки
млн: млн
многопользовательский: многопользовательские
множество: множеством
мочь: мог
мы: нам
назад: назад
найти: найдете найти
намёк: намеки
находиться: находиться
начало: начала
недавно: недавно
немало: немало
новизна: новизну
новинка: новинки
новость: новости
новый: новая новые новый
обновить: обновил
оглавление: оглавление
один: одним
ожидаться: ожидается ожидаются
опыт: опыт
опытный: опытным
оригинальность: оригинальность
основа: основе
основатель: основателем
особенно: особенно
особый: особого
останавливаться: останавливаться
открыто: открыто
открытый: открытым
открыть: откройте
относительно: относительно
отойти: отошли
отряд: отрядом
отставка: отставку
официальный: официального
охватывать: охватывает охватывая
охота: охота
очень: очень
первый: первая первый
переименовать: переименовали
пк: пк
план: планы
подарить: подарила
подборка: подборке
поджанр: поджанр поджанра
подписаться: подписаться подпишитесь
подписка: подписки
подписчик: подписчиков
подробность: подробностей
подтверждение: подтверждения
позволить: позволит
поиграть: поиграть
пока: пока
показать: показать
полноценный: полноценный
положительный: положительных
получить: получить
понравиться: понравятся
популярный: популярнейшего популярный
порождение: порождение
портфолио: портфолио
последний: последним
похоже: похоже
почитать: почитать
пошаговый: пошаговой пошаговые пошаговых
появиться: появились
правда: правдой
предназначение: предназначения
представлять: представляет
предугадывать: предугадывать
привлечь: привлечь
привнести: привнести
привычный: привычных
пример: примеров
принести: принесли
проблема: проблемы
проект: проект проектах проекте проектов проектом проекты
происходить: происходит
пройти: пройти прошёл
пропустить: пропустите пропустить
прослужить: прослужив
проходить: проходил
прошлое: прошлого
публикация: публикации
работать: работает
различный: различные
разный: разные
разрабатываться: разрабатывается
разработка: разработке разработкой
разработчик: разработчик разработчиков
разумеется: разумеется
рамка: рамки
ранний: раньше
раскрывать: раскрывают
рассказать: расскажем
расширение: расширением
реалистичный: реалистичная
ребёнок: детям
рекомендовать: рекомендуем
рендеринг: рендеринг рендеринга
решить: решила
ролевый: ролевая ролевой ролевые ролевых
ролик: ролики
рпг: рпг
самый: самые
свежий: свежие
свой: своего свои своими
себя: собой
сердце: сердца
сеть: сети
симулятор: симулятор
симуляция: симуляции
система: системой
скайрим: скайрим
следить: следить
слух: слухи
снова: снова
собираться: собирается
собрать: собрали
современный: современная современном
согласно: согласно
создавать: создавая
создать: созданного
сообщать: сообщают
сообщаться: сообщается
сопротивление: сопротивления
составляться: составляться
среди: среди
становиться: становится
стараться: старались
стать: стать
статья: статьи
стилизация: стилизацию
стилизованный: стилизованной
стилистика: стилистикой стилистику
стиль: стиле
стоить: стоит
стратег: стратегам
стратегия: стратегий
студия: студии
судить: судя
счастие: счастья
сюжет: сюжет
сюжетный: сюжетных
также: также
тема: темой тему темы
тематика: тематикой
топ: топ топе
требовать: требуют
тыс: тыс
удивить: удивили
уйти: уйти
умение: умения
усилие: усилиями
успешно: успешно
утверждать: утверждают
утечка: утечки
фермерство: фермерства
физически: физически
флаг: флаг
фэнтезийный: фэнтезийная фэнтезийной фэнтезийные
хватать: хватало
хидетака: хидетака хидетакой
хит: хита хитами
ходить: ходили
хороший: лучшие лучших
читать: читали
чёрный: чёрный
широкий: широкую
шутер: шутеров
шутереть: шутер
экспериментировать: экспериментирует
экшен: экшен
элемент: элементы
эмоция: эмоций
это: это
являться: является
