аддон: аддона
анонс: анонс
анонсировать: анонсирован
арена: арена арене
армагеддон: армагеддона
бесполезный: бесполезный
бета: бета
битва: битвы
блёклый: блеклыми
бой: боем боя
быть: буду
важный: важные
вакансия: вакансии
ваш: ваш ваша вашим
великий: великие
весь: всем
взглянуть: взгляните
видео: видео
видеоигра: видеоигры
возможность: возможности
войти: войти
время: время
всё: всё
вторичный: вторичных
второй: второй втором
выбрать: выбранным
выпустить: выпустить
выучить: выучить
выход: выходом
гейминг: гейминг
геймплей: геймплей
герой: героев герои героя героям
главный: главная
год: года
голосование: голосование голосования
город: город города городов
давать: давайте
дата: даты
дать: данной
два: двумя
девчонка: девчонки
дейли: дейли
делать: делал
демонстрировать: демонстрирует
день: дня
дзен: дзен дзене
днайва: днайв
добавить: добавив
документ: документы
достаточно: достаточно
доступ: доступе
думать: думаю
естественно: естественно
ещё: ещё
зайти: зайти
заклинание: заклинания
закрытый: закрытое закрытый
заметно: заметно
заявка: заявку
збт: збт
зоркость: зоркость
игра: играм игре игру игры
игрок: игроки
известно: известно
изменение: изменения
иметься: имеющиеся
интересно: интересно
интересоваться: интересуются
каждый: каждого
какой: какие
канал: канал канале
квартал: квартале
класс: классом
кликнуть: кликнуть
клинок: клинок
кнопка: кнопку
колдовство: колдовстве
количество: количество
команда: команды
комментарий: комментарии комментарий
комментировать: комментировать
конец: конце
контакт: контакты
коснуться: коснулись
который: которые
кронверк: кронверк
культовый: культовая культовой
лишь: лишь
любить: любят
магия: магии
март: марта
мельком: мельком
менее: менее
место: мест
месяц: месяц месяцев
меч: меча мечом
мешкать: мешкать
мина: мин
минута: минут минуты
млн: млн
мнение: мнение мнению
многие: многие
многий: многих
мочь: можем
наверняка: наверняка
навык: навык навыках навыки навыков
назад: назад
название: названии
наизусть: наизусть
найти: найти
написать: напишите
напомнить: напомним
начало: начала
недавний: недавний
неделя: недели
независимо: независимо
некоторый: некоторых
новость: новости
новый: новые
обессудить: обессудьте
обрадовать: обрадует
объективный: объективное
огонь: огнем
ограничить: ограничено
один: одна одно
одинаковый: одинаковые
оно: оно
опираться: опираться
описание: описанием
опрос: опрос опросе
основательный: основательной
особенно: особенно
остаться: остался
открыть: открыла
отличаться: отличаются
отличительный: отличительная
отправить: отправят
очень: очень
пара: пару
парень: парни
первый: первым
переработка: переработке
персонаж: персонажами
плохой: худшего
подать: подать
подвергнуться: подверглись
поделиться: поделились
подписаться: подписаться подпишитесь
подписка: подписки
подписчик: подписчиков
позволить: позволит
пока: пока
помнить: помнят
пора: пор
портрет: портретом
посвятить: посвящён
постичь: постигли
почитать: почитать
почта: почту
пощупать: пощупать
поэтому: поэтому
появиться: появился появиться
правда: правда
практически: практически
прежде: прежде
премьера: премьера
привет: привет
применяться: применяется
принять: приняли
продолжение: продолжения
пройти: пройдёт
пропустить: пропустите пропустить
профессия: профессия
прошлый: прошлой
публикация: публикации
разный: разным
разработчик: разработчики разработчиков
ранний: раннем
рассмотреть: рассмотрим
ребёнок: детям
революционный: революционными
регистрация: регистрацию
режим: режима
результат: результаты
рекомендовать: рекомендуем
релиз: релиза
ретрогеймер: ретрогеймер
ролевый: ролевые
ролик: ролик ролики
россия: россии
сам: самим самого самой
самый: самыми
свой: своем
свойство: свойство
сделать: сделал сделали
сей: сих
серия: серии
следить: следить
смочь: сможем
снг: снг
советовать: советуем
совпадать: совпадать
создатель: создатели
соответствие: соответствии
соответствовать: соответствующую
сопряжение: сопряжение
составить: составить
состояться: состоится
спешить: спешили
способность: способность
стать: стали стало станет
статья: статье статьи
страна: странах
страница: страницу
стратегия: стратегии
студия: студия
счастливчик: счастливчикам
считать: считаете
тайтлый: тайтла
также: также
такой: таким
тема: темой тему темы
тест: тест
тестирование: тестирование
тихо: тихо
топ: топ
тот: те той
точный: точной
трейлер: трейлер
третий: третьей третью
тройка: тройка
тыс: тыс
уведомление: уведомление
увеличить: увеличив
указать: указана
уникальный: уникальная уникальным
успеть: успел
участие: участие
фанат: фанатов
фракция: фракций
характеристика: характеристики
хороший: лучшему лучшими
часть: части часть
чей: чья
человек: человек
читать: читали
шанс: шанс
электронный: электронную
являться: являются
