автор: автора
аксессуар: аксессуары
анонс: анонс
анонсировать: анонсирована
близиться: близятся
бог: богов
больший: большую
быть: будут
вакансия: вакансии
ваш: ваш
весенний: весенней
взглянуть: взгляните
видео: видео
видеоигра: видеоигры
вновь: вновь
возвращение: возвращение
войти: войти вошла вошли
воспоминание: воспоминание
впервые: впервые
вселенная: вселенной
всё: всё
вторжение: вторжение
выходной: выходные выходных
гейминг: гейминг
герой: героя
главный: главная главных
год: год года лет
громкий: громкие
грубый: грубую
грядущий: грядущие
давать: давайте
давно: давно
девушка: девушка
действие: действия
день: дня
деньга: денег
десяток: десятков
дзен: дзен дзене
документ: документы
доступный: доступны
досуг: досуг
дотягивать: дотягивает
древний: древних
ещё: ещё
ждать: ждут
жизнь: жизнь
забагованная: забагованных
занимать: занимает
занять: занять
запланировать: запланирован
звать: зовут
зрение: зрения
игра: игр игра игры
играть: играла играть
игровой: игровой игровые
игрок: игрокам игроки
инди: инди
индустрия: индустрии
интересно: интересно
интересный: интересные
интересоваться: интересуются
источник: источник
итак: итак
какой: какие
канал: канал канале
киберспорт: киберспорт
комментарий: комментарии комментарий
комментировать: комментировать
комплектующие: комплектующие
консоль: консоли
контакт: контакты
континент: континенту
копилочка: копилочке
который: которой которую которые который которых
культовый: культовой
курс: курсе
лера: лера
лицо: лица
магазин: магазине
маркетинг: маркетинг
маркетолог: маркетолог
март: марта
мастер: мастеров
материал: материала материале
месяц: месяца
метать: метал
мина: мин
минута: минут минуты
млн: млн
многопользовательский: многопользовательские
мобильный: мобильные
момент: момент момента
муж: муж
мультиплеерный: мультиплеерные
назад: назад
найти: найти
наоэ: наоэ
написать: напишите
настоящий: настоящих
наш: нашем
недавно: недавно
неделя: недель
несколько: нескольких несколько
ниндзя: ниндзя
новинка: новинка новинки
новость: новости
новый: новая новой новые новый новых
обойти: обойти
один: одним
одиночный: одиночные
однако: однако
осень: осени
особый: особое
отношение: отношение
отправляться: отправляются
очень: очень
первый: первая первого первом первый первым
писать: пишу
плохой: худшей
подборка: подборку
поделиться: поделился
подписаться: подписаться подпишитесь
подписка: подписки
подписчик: подписчиков
подписываться: подписывайся
пожалуй: пожалуй
поиграть: поиграть
пока: пока
полагаться: полагается
поле: поле
получить: получила
популярный: популярных
портал: портал
последний: последних
посмотреть: посмотрим
почитать: почитать
поэтому: поэтому
появиться: появились
представить: представлены
презентация: презентации
привет: привет
приключение: приключения
провести: провести
продавать: продаваемых
продажа: продаж продажам
продвижение: продвижение продвижению
проект: проект проекты
происходить: происходить
пройти: прошла
пропустить: пропустите пропустить
публикация: публикации
разработка: разработки
распределять: распределяю
распродажа: распродаже
ребёнок: детям
рекомендовать: рекомендуем
релиз: релиз релиза релизы
решить: решили
ролевый: ролевые
ролик: ролики
российский: российские
рпг: рпг
русский: русская
самурай: самурай
самый: самую самых
седьмой: седьмую
серия: серии
сеть: сетях
сила: силу
симулятор: симуляторы
сказать: скажу
скачивать: скачивали
скидка: скидку
скрытность: скрытности
следить: следить
смочь: смогла смогут
собрать: собрать
социальный: социальных
специализироваться: специализирующаяся
сразу: сразу
старый: старые
статистика: статистикой
стать: стал станет
статья: статьи
стратегия: стратегии
строчка: строчку
студия: студии
сырой: сырых
сюжет: сюжету
также: также
такой: такие
тедас: тедас
тема: темой тему темы
технически: технически
тип: типа
тихий: тихих
тихо: тихо
товар: товаров
топ: топ топе
тот: тому
тыс: тыс
тёплый: тёплое
убийство: убийствах
угрожать: угрожает
уровень: уровня
услышать: услышали
участвовать: участвуют
учить: учил
учиться: учились
франшиза: франшизы
фэнтези: фэнтези
хит: хиты
хороший: лучшей хорошие
хэви: хэви
цифровой: цифровом
час: часов
часть: части часть
читать: читали
шедевр: шедевров
шутеры: шутеры
эксперт: эксперт
экшен: экшен
экшн: экшн
эльфийский: эльфийских
эмиграция: эмиграции
это: это
ясукэ: ясукэ
