автор: авторы
активность: активностью
амбициозный: амбициозных
анонс: анонсами
багаж: багаж
блезинск: блезински
блогер: блогеров
больший: большим
важный: важные
вакансия: вакансии
ваш: ваш
вдаваться: вдаваясь
вернуться: вернулись
весь: всем
ветеран: ветераны
взглянуть: взгляните
видео: видео
видеоигра: видеоигр видеоигры
виртуальный: виртуального виртуальный
внимание: внимание
войти: войти
впечатление: впечатления
впечатляющий: впечатляющим
время: время
всё: всё
вы: вами
вызвать: вызвал
выйти: выйдет вышел
выполнять: выполнять
выпустить: выпущенные
высокий: высокой
геймер: геймерам
гейминг: гейминг
главный: главная
глубина: глубину
год: года лет
головоломка: головоломкой
готовить: готовьте
график: графику
громкий: громкими
дать: данной
демке: демке
демоверсия: демоверсии демоверсию
день: дня
деятельность: деятельности
джон: джон
дзен: дзен дзене
диван: диван
документ: документы
долгий: долгое
дорогой: дорогие
доступ: доступ
другой: другие
ещё: ещё
её: её
желание: желание
живой: живыми
задача: задачи
заметить: заметить
занятый: заняты
захватывать: захватывающие
знакомый: знакомых
знаменитый: знаменитого
знать: знают
игра: игр играм игру игры
играть: играть
игровой: игровой игровые игровым игровых
игрок: игроков
издание: изданий
индустрия: индустрии
иной: иные
интерес: интерес
интересоваться: интересуются
испытание: испытаниями
исследовать: исследовать
исторический: историческим
канал: канал
кармак: кармак
киберспорт: киберспорт
классика: классики
клифф: клифф
комментарий: комментарии комментарий
комментировать: комментировать
контакт: контакты
кооперативный: кооперативный
который: которая которые
красочный: красочные
крейн: крейн
культура: культуры
легенда: легендами
легендарный: легендарные
лор: лор
любитель: любители
май: мая
мало: мало
март: марта
мерка: меркам
мероприятие: мероприятии
месяц: месяцев
мина: мин
минута: минут
мир: мира миром миру миры
млн: млн
многие: многие
многопользовательский: многопользовательские
молиний: молинье
мочь: могла
назад: назад
назвать: назвал
найти: найти
написать: напишите
настроение: настроения
начать: начнем
наш: нашем
недавно: недавно
неделя: неделю
необходимый: необходимого
новость: новости
новый: новые новый новых
обрести: обрели
обширный: обширной
общий: общих
огромный: огромной
одновременный: одновременных
окружающий: окружающего
окунуться: окунемся
описывать: описывать
опробовать: опробовали
особый: особый
оставаться: оставались
открытый: открытым
открыть: открыты
отлично: отлично
отметить: отметили
отмечать: отмечающих
отправиться: отправимся
отыскать: отыскал
очередь: очередь
пара: пару
парк: парком
паспорт: паспорт
пенсия: пенсию
первый: первую первым
перипетия: перипетия
песочница: песочницей песочницы
пик: пик
питер: питер
подписаться: подписаться подпишитесь
подписка: подписки
подписчик: подписчика
подробность: подробности
позволять: позволяющий позволяя
пока: пока
покидать: покидая
полный: полная полную
пользователь: пользователей
популярность: популярности
популярный: популярнее
похвастаться: похвастаться
почитать: почитать
превысить: превысил
предзаказ: предзаказы
представить: представили
прежде: прежде
привет: привет
привлечь: привлек
приглашать: приглашают
придание: придания
приключение: приключения
продлить: продлили
продолжать: продолжать
проект: проект проектов
пропасть: пропал пропасть
пропустить: пропустите пропустить
проработать: проработанную
публикация: публикации
путешествие: путешествие путешествия
пятый: пятая
радар: радаров
различный: различным различными
разработчик: разработчики
райт: райт
раскрывать: раскрывая
рассмотреть: рассмотрим
рассчитать: рассчитана
реакция: реакциями
ребёнок: детям
режим: режим
рекомендовать: рекомендуем
ролик: ролики
самый: самая самые
саундтрек: саундтреков
свежий: свежем свежий
свой: свой
связь: связи
сделать: сделало
сегодняшний: сегодняшней
серия: серии
сеттинг: сеттинг
симуляторный: симуляторном
следить: следить
сменить: сменил
собрать: собраны
совместно: совместно
создатель: создатели
создать: создавшие
спектор: спектор
справляться: справляться
сравнить: сравнил
сразу: сразу
становиться: становится
стараться: старался
статус: статус
стать: стали станет
статья: статье статьи статья
строительный: строительные
сфера: сферу
сюжет: сюжет
сюжетный: сюжетные
тема: темой тему темы
тень: тени
техника: техники
тихо: тихо
топ: топ топе
трейлер: трейлер трейлере
третий: третьей
трудиться: трудится
туризм: туризм туризма
увлекательный: увлекательное
уголок: уголкам
удивительный: удивительные
уилла: уилл
уоррен: уоррен
успеть: успели
успех: успеха
уютный: уютный
фанат: фанаты
фантастика: фантастики
фестиваль: фестивале
физика: физику
физический: физической
формат: формате
франшиза: франшизой франшизы
хаос: хаоса
хотеть: хочу
хроника: хроники
хронология: хронологию хронология
часть: часть
человек: людей люди
черта: чертах
честь: честь
читать: читайте читали
шутер: шутера
