автономный: автономном
адаптивность: адаптивностью
акттивный: акттивную
анализ: анализ
аналогичный: аналогичная
анонсировать: анонсировала
архитектура: архитектуру
аудиосистема: аудиосистемы
аудитория: аудитория
безмерный: безмерную
бернт: бернт
больший: больших
будущее: будущего будущее будущем
быстрый: быстрым
бёрний: бёрних
важный: важны
вакансия: вакансии
вдвое: вдвое
вероятно: вероятно
весы: весы
весь: всем всему
взглянуть: взгляните
видео: видео
видеоигра: видеоигры
визуально: визуально
внутри: внутри
войти: войти
впервые: впервые
впечатляющий: впечатляющая
время: временем
встретить: встречены
всё: всё
второй: вторая
вчера: вчера
выпускать: выпускают
выпустить: выпустила
выступать: выступают
выступление: выступления
выход: выход выходе
вычисление: вычислениями
гаджет: гаджеты
гейминг: гейминг
гендиректор: гендиректор
генерация: генерации
геншина: геншин
герман: герман
глава: глава
главный: главная
глаз: глазом
глубокий: глубокого
год: году
господин: господин
готовый: готовы
графический: графические
гуманоид: гуманоидов
данные: данным данных
два: двумя
движение: движения
двухсистемный: двухсистемную
действие: действия
действовать: действующая
демонстрация: демонстраций демонстрациях
дженсный: дженсен
дзен: дзен дзене
документ: документы
дополнительный: дополнительное дополнительную
достижение: достижения
доступ: доступ
другой: других
думать: думающая
ещё: ещё
её: её
жизнь: жизнь
завалиться: завалившийся
зависеть: зависит
задача: задач задачах задачи
заключить: заключена
замедление: замедления
заменять: заменять
захват: захват
заявить: заявил
значимый: значимую
золотистый: золотистого
игра: игры
игровой: игровой игровые
изображение: изображения
иметь: имеет
индустрия: индустрии
инструкция: инструкциях
инструмент: инструментами
интеллект: интеллекта
интересный: интересного интересных
интересоваться: интересуются
интуиция: интуиции
искусственный: искусственного
использование: использование
источник: источник
ия: ии
камера: камеры
канал: канал
китайский: китайское
книга: книги
колонка: колонки
комбинация: комбинация
компания: компании компания
компаньон: компаньонами
компьютер: компьютерах
конкретный: конкретных
консоль: консоли
контакт: контакты
корпус: корпус
который: которая которую которые который которым которых
кремний: кремния
крупный: крупный
купить: купить
курс: курсе
либо: либо
луна: луне
максимальный: максимальная
массачусетский: массачусетского
медленно: медленно
менять: меняет
мероприятие: мероприятии
месяц: месяца месяцев месяцы
механизм: механизмами
мина: мин
минимальный: минимальным
минута: минут минуты
мир: мир мире миру
миссия: миссии
млн: млн
многоэтапный: многоэтапные
моделирование: моделирование моделировании
модель: модели модель
модуль: модуль
мозг: мозг
мочь: могут можем можете
мощность: мощность
мощный: мощных
мышление: мышлением мышления
набор: набором
навык: навыков
назад: назад
название: название
назначение: назначения
называть: называет
найти: найти
напечатать: напечатали
напоминать: напоминает
насколько: насколько
настать: настала
настольный: настольный настольных
настраивать: настраиваемой
настройка: настройку
наушник: наушники
начало: начала
начать: начали
наш: наш наша
невооружённый: невооружённым
необходимый: необходима
непрерывный: непрерывные
нержавеющий: нержавеющая
нестабильность: нестабильностью
новинка: новинки
новость: новостей новости
новый: новую новые новый новыми
носить: носила
ноутбук: ноутбуках ноутбуки
о: обо
обеспечить: обеспечила
область: области
обновить: обновлённая
оборудование: оборудование
образ: образу
обучение: обучение обучением обучения
общий: общего
овладеть: овладела
один: одни одной
одиссей: одиссей
оказывать: оказывать
окружение: окружении
они: ними
оператор: операторы
опираться: опираться
опробовать: опробовать
ориентировать: ориентирована
основа: основе основой
основный: основных
отечественный: отечественным
открытый: открытой
открыть: откроют открыла
отраслевой: отраслевые
оценка: оценки
первый: первая первую
передаваться: передаётся
перемещение: перемещение
пк: пк
план: план
планировать: планировать
планшет: планшеты
платформа: платформах платформу платформы
поведение: поведение
погибнуть: погибнуть
подписаться: подписаться подпишитесь
подписка: подписки
подписчик: подписчиков
поколение: поколения
полностью: полностью
полупроводник: полупроводников
получить: полученных
польза: пользу
помочь: помогла поможет
помощь: помощи помощь
последний: последние
постобучение: постобучением
потребность: потребностей
почему: почему
почитать: почитать
предварительный: предварительное
предмет: предметов
предназначить: предназначенную
предоставляться: предоставляются
представить: представила
представлять: представляют
прежде: прежде
преобразовать: преобразует
приближаться: приближается
привычный: привычный
принести: принёс
проблема: проблем
провести: провести
проводиться: проводилось
программный: программный
продвинуться: продвинувшись
продемонстрировать: продемонстрировал
проект: проект
производительность: производительность
производить: производит производить
происходить: происходит
пройти: прошла
прокомментировать: прокомментировал
пропустить: пропустите пропустить
прорыв: прорыв
против: против
профессионал: профессионалов
процессор: процессоров процессоры
прочный: прочнее
прошлый: прошлом
публикация: публикации
работа: работе
рабочий: рабочая
радиоастрономия: радиоастрономии
развернуть: развернуть
различие: различия
разработчик: разработчикам
рассказать: рассказала рассказать
рассуждение: рассуждений рассуждения
ребёнок: детям
режим: режиме
рекомендовать: рекомендуем
ресурсоёмкий: ресурсоемких
рефлекс: рефлексам
робот: робота роботов
робототехника: робототехники
ролик: ролики
российский: российские
россия: россии
рубеж: рубеж
рука: руками
сайт: сайте
самый: самыми самых
свой: своей
связь: связи
сдержанно: сдержанно
себя: собой
сильно: сильно
синтетический: синтетических
система: система систему системы
скорректировать: скорректировать
скрываться: скрываются
следить: следить
сложный: сложные сложных
смартфон: смартфонах смартфоны
смоделировать: смоделированных
смочь: смогли сможет
собранный: собранных
совершенно: совершенно
современный: современной современный
создание: создании созданию
создатель: создатели
сократиться: сократилась
сообщить: сообщила
соперничество: соперничестве
составить: составленный
способный: способные способными
справиться: справиться
средство: средства
сталь: сталь
станция: станция
статья: статьи
страдать: страдают
строить: строит
существенный: существенные
сфера: сферах
сценарий: сценариям
также: также
такой: таких
тема: темой тему темы
техника: технике
технологический: технологического
технология: технологии
точный: точные
требоваться: требуется
трекер: трекеры
тыс: тыс
тяжёлый: тяжелыми
уборка: уборку
увидеть: увидеть
уметь: умеющего
умный: умные умных
участие: участием
учёный: учёные учёных
фитнес: фитнес
флагманский: флагманскую
фототехник: фототехника
фреймворк: фреймворками
характеристика: характеристики
ход: ходе
хороший: лучшие лучших
хотя: хотя
хуанга: хуанг
цвет: цвета
часы: часах часы
человек: людям человека
человекоподобный: человекоподобного человекоподобных
человеческий: человеческим человеческого
читать: читайте читали
элегантный: элегантный
электроника: электроника электроники электронику
электронный: электронные
эпоха: эпоха эпоху
это: это
этот: эта
являться: являются
языковой: языковая
