абсолютный: абсолютной
автоматически: автоматически
аксессуар: аксессуары
антагонист: антагонистом
антагонистка: антагонистками
атака: атак атаке атаки
атаковать: атаковать
баррикада: баррикад
ближний: ближнего ближнем
бог: боже
боевой: боевых
боец: боец бойцов бойцом бойцы
бой: бой бою боя
бородатый: бородатого
босс: боссам боссов боссом боссы
бояться: боятся
бравлера: бравлерах
бравль: бравле
будущее: будущем
быстро: быстро
быстрый: быстрее быстрых
вакансия: вакансии
вблизи: вблизи
взглянуть: взгляните
видео: видео
видеоигра: видеоиграх видеоигры
вначале: вначале
внезапный: внезапных
войти: войти
волкмайра: волкмайр
вообще: вообще
ворваться: ворвётся
вперёд: вперёд
враг: врагам врагов
время: время
врываться: врывайся
всё: всё
вчера: вчера
вывод: вывод
выживаемость: выживаемость
вытянуть: вытянуть
гаджет: гаджет гаджетов
геймер: геймера геймеру
гейминг: гейминг
главный: главная главным
говорить: говорит говорю
год: года лет
готовиться: готовиться
готовый: готов готовы
градус: градусов
давать: даёт
движение: движения
делать: делает делают
держать: держи держит
дешёвый: дешевой
джесси: джесси
дзен: дзен дзене
дистанция: дистанцию
добираться: добираться
документ: документы
долгий: дольше
другой: другим другому другую
думать: думал
дэррил: дэррил дэрриле дэррилом
ещё: ещё
её: её
жаба: жаб
ждать: ждать
завлечь: завлечь
замедлить: замедлить
замедлять: замедляет
запас: запасе
запомнить: запомнили
запредельный: запредельной
заряжаться: заряжается
заставить: заставить
захват: захват захвате
звёздный: звёздная звёздных
здоровье: здоровье
злодей: злодеев
злодейка: злодейки
знакомство: знакомства
значит: значит
зона: зоны
игра: игр играх игре игры
играть: играет играть
игроблог: игроблог
игровой: игровой игровом игровые
игрок: игрок игроки
игрулька: игрулькой
изменение: изменений
изменить: изменили
имбой: имбой
имя: имя
индустрия: индустрии
интересоваться: интересуются
интерфейс: интерфейс
использовать: использовать используй
казаться: казались
какой: каким
канал: канал канале
карта: карту
каток: катки каток
качать: качать
киберспорт: киберспорт
классический: классическую
ключевой: ключевым
коварный: коварны
командный: командных
комбинация: комбинацию
комментарий: комментариях
комплектующие: комплектующие
конец: конце
консоль: консоли
контакт: контакты
контент: контенту
контролировать: контролируй
контролита: контролит
контроль: контроля
королева: королева
король: король
короткий: коротком
который: которые который
красивый: красивые
крепкий: крепче
кристалл: кристаллов
кстати: кстати
кто: кого
куст: кусты
кучно: кучно
лайк: лайк
лететь: летят
ломать: ломают
любимый: любимого
любой: любом
масса: массу
мастер: мастер
машина: машиной
менее: менее
меняться: меняется
место: местах месте
месяц: месяца месяцев
мета: мета мете мету
мина: мин
минута: минут минуты
млн: млн
многие: многие
многое: многое
многопользовательский: многопользовательские
мобильность: мобильность
мобильный: мобильнее мобильные
моделька: модельки
мочь: мог
мы: нам
навсегда: навсегда
навстречу: навстречу
награда: наград
назад: назад
найти: найти
нанесение: нанесения
наносить: наносит наносить наносят
нападать: нападать
настоящий: настоящее
наш: наш нашего наши
недооценивать: недооценивают
недооценить: недооценённые
некоторый: некоторые
неожиданно: неожиданно
неожиданный: неожиданного неожиданных
несколько: нескольким несколько
низкий: низком
новинка: новинки
новость: новости
новый: новом новые
нокаут: нокаута
обновление: обновлений обновления
общество: общество
оглавление: оглавление
ограбление: ограбление
огромный: огромный
одиночный: одиночного одиночные
опасный: опасна опаснейший опаснейшим
осада: осада
особенно: особенно
остаться: остаться
открытый: открытом
отличный: отличный
отпускать: отпускать
охотник: охотник
очень: очень
пасхалка: пасхалки
первый: первое первые первый первым первых
перекатываться: перекатываться
перенестись: перенесемся
персонаж: персонаже персонажей
писать: пиши
план: планами
повышать: повышая
поглощение: поглощение
подкидывать: подкидывает
подписаться: подписаться подпишитесь
подписка: подписки
подписчик: подписчиков
подробно: подробно
подумать: подумай подумать
подход: подхода
позволять: позволяет позволяют
позиция: позиции
показать: показать
поле: поля
полезный: полезнее
понять: понять
попасть: попасть
попахивать: попахивала
пора: пор
поскольку: поскольку
последний: последний последних
постоянно: постоянно
почитать: почитать
появляться: появляется
правило: правило
правильно: правильно
правильный: правильную правильных
предлагать: предлагают
препятствие: препятствиями
привет: привет
прийтись: придется
приключение: приключений приключения
пример: примеры
прислать: пришли
приходиться: приходилось
проблема: проблем
проект: проект
пройти: прошло
прокачка: прокачка
пропустить: пропустите пропустить
простой: проще
против: против
противник: противников
процесс: процессе
прямо: прямо
публикация: публикации
пушить: пуша
работать: работает
рад: рад
разбирать: разбираем
разносить: разносят
разобраться: разобраться
разработчик: разработчики
разрушение: разрушения
ранг: рангах рангов
ранний: раньше
реально: реально
реальный: реальный
ребёнок: детям
редко: редко
режим: режимах режимов
реклама: реклама
рекомендовать: рекомендуем
решить: решили
рикошет: рикошет рикошетов
ровно: ровно
ролевый: ролевые
ролик: ролики
российский: российские
рука: руках руки
самый: самые самый самых
сборка: сборка
свой: своими своё
сдаться: сдаться
сделать: сделали
сегодня: сегодня
сезон: сезоне
сей: сих
серия: серии
серьёзный: серьезное
сила: сил сила силу
сильный: сильнее сильных
система: система
скин: скинах
скорость: скорость
скрытый: скрытая
слабый: слабы слабыми
следить: следить
сложность: сложности
сложный: сложнее сложные сложных
сломать: сломать
случай: случай
смертельный: смертельных
смертоносный: смертоноснее
снаряд: снаряды
снова: снова
собрать: собрать
сокращать: сокращать
соло: соло
спина: спину
сражение: сражение
сразу: сразу
средний: средним
ставить: ставь
старый: старом
стать: стал стала стали стало
статья: статьи
стоить: стоит
столкновение: столкновения
столько: столько
сторона: сторону
стоящий: стоящих
странный: странная странными
стратегия: стратегии
стрельба: стрельбы
супер: супер
суперспособность: суперспособности
такой: такого
танк: танк танки танков танком
тапа: тапа
таран: таран
тащить: тащит
телеграм: телеграм
тема: темой тему темы
типичный: типичным
толпа: толпу
топ: топами
тропический: тропический
трудный: трудный
турбо: турбо
турель: турели турель
тыс: тыс
тёмный: тёмная
убивать: убивать
убийца: убийц убийца
увеличивать: увеличивает
увеличить: увеличена увеличили
угол: угла
угроза: угроза
удалить: удалить
удар: удар удары
удвоение: удвоения
удивить: удивил
ульт: ульта ульте ульту ульты
уменьшать: уменьшает
уничтожать: уничтожать
урон: урон урона
усиливать: усиливает
ускорить: ускорили
успешный: успешной
устраивать: устраивать
фистфайта: фистфайт
формула: формулу
хаос: хаос
хороший: лучшая лучший лучших хорош
целиться: целиться
чар: чарами
читать: читали
что: чему
шутеры: шутеры
эвелина: эвелин
эдгар: эдгар эдгаре
экшн: экшн
энергопоток: энергопоток
это: это
являться: является
яркий: яркие
