автоматон: автоматонами
азиатский: азиатский
блог: блога
боевой: боевая
бой: боя
вакансия: вакансии
ваш: ваш вашего
великий: величайшую
вернуться: вернуться
взгляд: взгляд взглядом
взглянуть: взгляните
включать: включает
вместе: вместе
внутри: внутри
возвести: возведенный
возвращаться: возвращаться возвращаюсь
возможность: возможность
возможный: возможных
восторг: восторг
время: временем
выдать: выдали
выдающийся: выдающимся
выдержать: выдержать
вызывать: вызывая
выйти: выйдет
выход: выхода
геймдева: геймдев
геймдизайнер: геймдизайнеров
геймер: геймеру
геймингнайти: геймингнайти
геймплейный: геймплейный
гигантский: гигантский
глубина: глубины
глубокий: глубокую
год: года году лет
годааналитик: годааналитики
громкий: громкий
давно: давно
дата: дату даты
дать: дав
демонстрировать: демонстрирующий
день: дня
десятка: десятки
деталь: деталей детали
дзен: дзен
дзеневакансиидзен: дзеневакансиидзен
добыча: добычи
документ: документы
доступный: доступна
древний: древними
единственный: единственной
желание: желание
забыть: забудь
забыться: забылись
загадочный: загадочная загадочного
западный: западному западным
запоминаться: запоминающихся
запрос: запросам
зона: зона
игра: игр игра играх игре игры
игровой: игровых
игропром: игропром
именно: именно
иметь: имеющими
империя: империю
интересуютсяследить: интересуютсяследить
интерфейс: интерфейсом
испытание: испытание
исследование: исследование
исчезнуть: исчезнувшей
кабат: кабату
какой: какие
канал: канал
квест: квесты
кино: кино
китайский: китайские китайский
количество: количеству
колорит: колорит
колумбия: колумбия
комментарий: комментарий
комментироватьпока: комментироватьпока
компания: компании
компьютерный: компьютерных
контакт: контакты
контроллер: контроллера
концовка: концовок
который: которые которыми которых
критик: критиков
лайк: лайк
лидер: лидером
линия: линия
май: мая
мастерство: мастерства
месяц: месяца месяцев
механика: механики механику
меч: меч
миниздатель: миниздатель
минутыиграть: минутыиграть
минутыникит: минутыникита
мир: мира мире миров миры
мировой: мировой
млн: млн
многий: многих
модификация: модификацию
монолит: монолит монолита
мощный: мощной
мы: нам
навык: навыков
надежда: надеждой
назадподписатьсяновый: назадподписатьсяновые
назадподписатьсяэти: назадподписатьсяэти
найти: найти
настроить: настроить
наёмник: наемник
небесный: небесная
неизвестный: неизвестной
непреодолимый: непреодолимое
несколько: несколько
несмотря: несмотря
новый: новая новые новым
обещать: обещает
обнаружить: обнаружившая
обсуждать: обсуждаемых
объявление: объявлением объявления
олегович: олегович
опасность: опасности
опубликовать: опубликовали опубликован опубликованных
основной: основные
остаться: оставшимися
остров: остров
отпускать: отпускают
первый: первый
первымрекомендовать: первымрекомендуем
периодически: периодически
персонаж: персонажами
планета: планете
платформа: платформ
подарить: подарила
подводный: подводный
подписчикаподписатьсясемиминутный: подписчикаподписатьсясемиминутный
подписываться: подписывайся
позволять: позволяет позволяющая
поиск: поиски
полностью: полностью
получить: получивших
пользовательский: пользовательским
понятный: понятным
популярность: популярность
посмотреть: посмотрели
поставить: поставить
построить: построить
посчитать: посчитали
пошаговый: пошаговых
предпочтение: предпочтения
представить: представить представлена
предстоять: предстоит
прибывать: прибывает
признание: признание
провести: провели
проект: проект
проникнуть: проникнуть
пропустить: пропустите пропустить
протяжение: протяжении
публикациина: публикациине
рад: рад
разветвить: разветвленная
разворачиваться: разворачивается
разгадать: разгадать
разработать: разработанным
разработчик: разработчик разработчики
рамка: рамках
ранний: ранний
раскрыть: раскрыли
рассказать: расскажу
революционный: революционная
релиз: релиза
ролевый: ролевого
самый: самых
сбор: сбор
своеобразный: своеобразным
свой: свой
сегодня: сегодня
седьмой: седьмой
семиминутный: семиминутный
серия: серии
сила: силах
система: система
скриншот: скриншоты
скрываться: скрываются
скрытый: скрытых
сложность: сложность
смертельный: смертельные
сми: сми
снова: снова
сноватемерия: сноватемерия
собственный: собственные
создатель: создателей
создать: созданными
сооружение: сооружения
соответствовать: соответствующий
сотня: сотни
сохранить: сохранив
специально: специально
способный: способную способный
справиться: справиться
сражаться: сражаться
сразу: сразу
стандарт: стандартам
становиться: становится
стать: станет статей стать
статья: статье
стиль: стиль
стратегия: стратегий
стремиться: стремясь
считаться: считался
сюжетный: сюжетная
также: также
тамриэль: тамриэль
тема: темой
темувидеостатьироликиновостивидеоигрыдетямвсё: темувидеостатьироликиновостивидеоигрыдетямвсё
темувойтиглавнаяподпискинайти: темувойтиглавнаяподпискинайти
темымногопользовательский: темымногопользовательские
титр: титров
тихонаписать: тихонапишите
требовать: требующую
трейлер: трейлер
туссента: туссент
тыс: тыс
тысяча: тысячи
улучшение: улучшения
успех: успех
фанат: фанаты
фантазия: фантазия
февраль: февраля
финальный: финальных
функция: функциями
хотеться: хочется
цивилизация: цивилизацией цивилизации
час: часов
часть: часть
читать: читали
экипаж: экипаж
экипировка: экипировки
экспедиция: экспедиция
экшен: экшена
элитный: элитный
эндория: эндория
этот: эта этих
