автопилот: автопилоте
андеграундный: андеграундных
анонс: анонсом
бесплатно: бесплатно
бесплатный: бесплатный
буквально: буквально
быстро: быстро
вакансия: вакансии
версия: версии
весенний: весенней
весь: весь всему
взглянуть: взгляните
видеоигра: видеоигр
виновник: виновник
внутренний: внутренняя
внушительный: внушительным
возможность: возможность
волнение: волнение
впоследствии: впоследствии
время: времени время
вроде: вроде
всплеск: всплеск
выглядеть: выглядит
выгодный: выгодной выгодными
выделяться: выделяется
выйти: вышел
выпускать: выпускает
выпустить: выпустив
вырасти: вырос
высокий: высокие
выход: выход
гвоздь: гвоздь
глава: главы
главный: главными
год: года году лет
график: графику
графический: графический
гроб: гроб
дать: дало
два: две
дважды: дважды
дебютировать: дебютировала
декабрь: декабре
делиться: делиться
день: дня
дзен: дзен
дзеневакансиидзен: дзеневакансиидзен
дикий: дикая
добраться: добралась
документ: документы
доллар: долларов
домой: домой
дорога: дороги
достигнутый: достигнутые
достигнуть: достиг
доступный: доступна доступны
драйвер: драйверами
друг: друзей
ещё: ещё
её: её
жанр: жанре
журналист: журналистов
забить: забила
завоевать: завоевала
заслужить: заслужила
игра: игр игра игре игру игры
игровой: игровой игровую игровые игровым
игрок: игрока игроков
идея: идей
изображение: изображением изображения
империя: империя
интерес: интереса
интересный: интересных
интересуютсяследить: интересуютсяследить
интуитивно: интуитивно
история: истории история
источник: источник
итог: итоге
каменный: каменные
канал: канал
консоль: консоль консолью
контакт: контакты
контроллер: контроллер
который: которому которые которых
кража: кражи
крупный: крупное крупные
культовый: культовая
купить: купил купить
личный: личный
лишиться: лишились
любимый: любимым
май: мая
максимальный: максимальный
март: марта
месяц: месяца месяцев
минкультовый: минкультовая
минутыгерман: минутыгерман
мир: мир
млн: млн
мой: мое моим
момент: момент
награда: наград
назадподписатьсяистория: назадподписатьсяистория
назадподписатьсяон: назадподписатьсяон
найти: найти
настоящий: настоящее
начало: начала
невероятно: невероятно
недавний: недавнего недавнее
немного: немного
непростой: непростой
несколько: несколько
новость: новостей
новый: новые новый
номинация: номинации
обновить: обновила
обновление: обновление
обычно: обычно
один: одну
однако: однако
одновременный: одновременного одновременных
ожидаться: ожидается
онлайн: онлайн онлайна
особо: особо
оставаться: остаётся
ответ: ответа
отличный: отличной
отчитаться: отчитался
охота: охота
оценка: оценки
очаровательно: очаровательно
очень: очень
панель: панелью
первый: первое первые
пережить: пережила
пиковый: пикового пиковый
платформа: платформе
площадка: площадке
победа: победа
побить: побив побила
повезти: повезёт
поддерживать: поддерживать
подписаться: подпишитесь
подписчиковподписатьсяспустя: подписчиковподписатьсяспустя
подтвердить: подтвердить
поздний: позже
показатель: показатель
поколение: поколение
покупка: покупки
получить: получил
пользователь: пользователей пользователь
понятный: понятный
попасть: попала
популярность: популярность
пора: пор
порождение: порождение
посвятить: посвященный
последний: последнее последний
потерять: потеряли
появиться: появились
право: прав
превышать: превышал
предложение: предложениями
представить: представило
презентация: презентации
пример: пример
принести: принёс
приобрести: приобрести
приставка: приставку
причём: причём
продолжение: продолжением
произведение: произведение
пройти: прошли
пропустить: пропустите пропустить
прославиться: прославилась
протаранить: протаранила
процесс: процессом
публикациина: публикациине
публикацииподписатьсярекомендовать: публикацииподписатьсярекомендуем
публикация: публикации
пустой: пустой
путь: путь
разочарование: разочарованием
распродажа: распродаже распродажи
реальный: реальном
редактор: редактор
резкий: резкий
результат: результатом
рекорд: рекорд
рекордный: рекордной
релиз: релиза
ролевый: ролевая
рост: роста
рубль: рубля
рынок: рынка
сайт: сайте
свой: своё
связаться: связался
секция: секцию
семь: семь
сенсорный: сенсорной
сентябрь: сентябре
сердцамногопользовательский: сердцамногопользовательские
серьёзный: серьёзный
скидка: скидки
событие: событие
сопровождаться: сопровождается
список: списком
спустя: спустя
среди: среди
средне: средне
стать: стал станут
статья: статьи
стена: стену
сторона: стороны
студия: студии студию студия
судить: судя
талантливый: талантливых
тема: темой
темувидеостатьироликиновостивидеоигрыдетямвсё: темувидеостатьироликиновостивидеоигрыдетямвсё
темувойтиглавнаяподпискинайти: темувойтиглавнаяподпискинайти
темыролевый: темыролевые
типичный: типичных
тоби: тоби
тот: тех
третий: третьей
три: трёх
трудиться: трудится
тусовка: тусовок
тыс: тыс
убитый: убита
убить: убил
удаться: удалось
улучшить: улучшенную
успех: успех успеха
фокс: фокс
фокса: фокса
фон: фоне
хороший: лучшая лучшим
цена: цене
церемония: церемонии
человек: человек
четвёртый: четвёртой
число: числе
читать: читали
чёрный: чёрный
эпизодический: эпизодическим
эстонский: эстонская
это: это
