активация: активации
активировать: активировать
апрель: апреля
аудитория: аудитория
баг: багов
боевой: боевая боевой
бой: бой бою
большой: большом
быстрый: быстрее
вакансия: вакансии
вдвое: вдвое
версия: версия
взглянуть: взгляните
вкладывать: вкладываете
включать: включает включал
влиять: влиять
возможность: возможность
вслед: вслед
вступать: вступать
выбор: выборе
выйти: выйдет вышла
вынуждать: вынуждает
высокий: высокие
выход: выхода
геймплей: геймплее геймплей
герой: герой
год: года году
грязный: грязным
далее: далее
дата: дата даты
два: две
делать: делает
дело: деле
десять: десяти десять
дзен: дзен
дзеневакансиидзен: дзеневакансиидзен
динозавр: динозавров
длинный: длинный
добавить: добавили
добраться: доберётся
дождаться: дождались
документ: документы
достигнуть: достигла
доступ: доступ
драка: драки драку
другой: другого
ещё: ещё
её: её
железо: железу
завалиться: завалившийся
зависимость: зависимости
закликивательный: закликивательных
замедление: замедления
заменять: заменять
заметный: заметные
заниматься: занимается
запуск: запуска
заслужить: заслужила
застенчивый: застенчивым
значит: значит
игра: игр игра играм игре игру игры
игровой: игровой игровые
игрок: игроками игроки игроков игроком
игрыроссийский: игрыроссийские
игрыэкшн: игрыэкшн
известно: известно
изображение: изображения
изучить: изучить
индро: индро
индустрииигра: индустрииигры
инопланетяней: инопланетянеи
интересный: интересных
интересуютсяследить: интересуютсяследить
исторический: исторических
история: история
источник: источник
казуальный: казуальным
канал: канал
киберспортодиночный: киберспортодиночные
китайский: китайское
ковка: ковкой
команда: командой
комбинация: комбинациях
комплектующиешутерымногопользовательский: комплектующиешутерымногопользовательские
консолиновинка: консолиновинки
консоль: консолях
консольный: консольной
контакт: контакты
копия: копий
кот: кот
который: которого которую которых
критик: критиков
купитьмасштабный: купитьмасштабный
куча: куча
лайфхакина: лайфхакине
локализация: локализации
луна: луне
март: марта
масса: массу
масштабный: масштабный
мелодия: мелодии мелодий
менее: менее
меняться: меняются
месяц: месяц
минвыйти: минвышедший
минимум: минимум
минута: минут
минуткибер: минуткибер
минутыкибер: минутыкибер
мир: мире
млн: млн
многие: многие
многий: многих
модификатор: модификаторов
модуль: модуль
назадподписатьсябоевой: назадподписатьсябоевая
назадподписатьсяпасхалка: назадподписатьсяпасхалки
найти: найденная найти
насвистывать: насвистывает
наслать: нашли
настройка: настройках
начало: начала
начать: начали начать
начинаться: начинаются
наш: нашей
негативно: негативно
негативный: негативных
неделя: неделе недели
незнакомец: незнакомцев
некоторый: некоторые
несколько: несколько
новинка: новинки
новичок: новичкам
новость: новостей
новый: новой новые
нужно: нужно
обещать: обещанный
обнаружить: обнаружил
обновление: обновления
оборудование: оборудование
объём: объём
обязательно: обязательно
одиссей: одиссей
однако: однако
ожидаться: ожидается
окончание: окончания
он: нему
оператор: операторы
описание: описание
опыт: опыта
оригинал: оригинале
оригинальный: оригинальной
оружие: оружия
основа: основы
основать: основана
оставлять: оставляет
отечественный: отечественным
открытый: открытом
отличие: отличие
отметить: отметить
официальный: официального официальной
охотный: охотнее
оценка: оценки
пасхалка: пасхалки
пасхалок: пасхалок
патч: патч
первый: первой первых
персонаж: персонажа
пк: пк
повсюду: повсюду
погибнуть: погибнуть
подготовка: подготовке
подковать: подкованные
подписаться: подпишитесь
подписчиковподписатьсяигрок: подписчиковподписатьсяигроки
пока: пока
покидать: покидают
поклонник: поклонники
получать: получаемого
получить: получить
польза: пользу
помощь: помощью
пост: посте
потенциальный: потенциальный
почему: почему
поэтому: поэтому
появиться: появится
правильный: правильном
прежде: прежде
претендент: претендент
привыкнуть: привыкшим
приключение: приключение
принести: принёс
причина: причина
продать: проданных
продолжиться: продолжится
пройти: пройти
прокачиваться: прокачиваться
пролог: пролога
прописать: прописать
пропустить: пропустите пропустить
прошлый: прошлой прошлом
публикациина: публикациине
радиоастрономия: радиоастрономии
разблокировать: разблокировать
рассказывать: рассказываем
режим: режим режима режиме
релиз: релиза
ритм: ритме
розыгрыш: розыгрыш
ролевый: ролевого ролевые ролевых
российский: российские
россия: россии
русский: русской
ряд: ряд
сайт: сайте
сам: самом
самолёт: самолет
самый: самые
сапог: сапогах
свобода: свободы
связка: связок
связь: связи
середина: середине
серия: серии
сила: силы
система: система системы
системный: системные системных
скачать: скачать
скрываться: скрывается
смочь: смогли
собрать: собрали
событие: события
совет: советы
содержать: содержать
сократиться: сократилась
способ: способ
спрятать: спрятаны
сразу: сразу
средневековый: средневекового
становиться: становится
стоить: стоит
стратегия: стратегии
сюжет: сюжет сюжете
сюжетный: сюжетный
также: также
телега: телеге
темувидеостатьироликиновостивидеоигрыдетямвсё: темувидеостатьироликиновостивидеоигрыдетямвсё
темувойтиглавнаяподпискинайти: темувойтиглавнаяподпискинайти
темуигровой: темуигровые
технически: технически
тот: те
требование: требования требованиях
трейлер: трейлер
третий: третий
три: трех
тщательный: тщательной
тыс: тыс
удар: удар ударов
улучшить: улучшенный
уменьшать: уменьшает
усложнять: усложняющих
услышать: услышать
фанат: фанаты
февраль: февраля
финальный: финальной
форум: форума
хардкорн: хардкорном
хардкорный: хардкорного хардкорный
хороший: лучшую
хотя: хотя
часть: части
человек: людям
четвёртый: четвёртый
читать: читали
шанс: шансы
экшен: экшена экшенов
это: этим это
являться: является
