аксессуар: аксессуары
аркхема: аркхем
атмосфера: атмосферу
бодик: бодикам
бояться: бояться
бум: буму
важно: важно
вакансия: вакансии
ваш: ваш
вдохновить: вдохновлённая
взгляд: взглядом
взглянуть: взгляните
вид: видом
видео: видео
видеоигра: видеоигр видеоигры
видеокамера: видеокамера
возвращение: возвращение
война: войн
войти: войти
впечатление: впечатлениях
встреча: встречах
всё: всё
второй: второй
вчера: вчера
выживание: выживание
выйти: выйдет выйдут
выпустить: выпустили
гейминг: гейминг
герой: герой
главный: главная главный главных
год: год года году
головоломка: головоломок
городок: городке
горожанин: горожанин
готовиться: готовится
готовый: готовы
движение: движения
делать: делает
демоверсия: демоверсия
демон: демонами
детектив: детектив
дзен: дзен дзене
документ: документы
доступный: доступен доступна
душевный: душевную
дёргаться: дергающейся
ещё: ещё
жанр: жанр жанре
желать: желающих
запланировать: запланирован
захватывать: захватывающий
захлестнуть: захлестнуло
игра: игр игра играх игры
игровой: игровой игровые
игрок: игрокам игроков
известно: известно
извратить: извращённой
издатель: издателем
измученный: измученного
именно: именно
имитировать: имитирующей
инвентарь: инвентарём
индустрия: индустрии
инновационный: инновационные
интересный: интересных
интересоваться: интересуются
использоваться: использовалась
исследование: исследовании
история: историю
каждый: каждый
камера: камерой камеру
канал: канал
картинка: картинки
киберспорт: киберспорт
кишеть: кишащей
классика: классикой
классический: классических
комментарий: комментарии комментарий
комментировать: комментировать
комплектующие: комплектующие
консоль: консоли
контакт: контакты
который: котором которые который
кошмар: кошмара кошмарами
крейн: крейн
кровавый: кровавых
кто: кем
легендарный: легендарная
лицо: лица
любитель: любителей
любительский: любительской
любопытный: любопытный
магия: магии
май: мая
март: марта
менеджмент: менеджменте
месяц: месяца месяцев
механика: механики
мина: мин
минута: минут минуты
мир: мире
млн: млн
многопользовательский: многопользовательские
множество: множество
мобильный: мобильные
момент: момент
мрачный: мрачное
наводнение: наводнение
назад: назад
найти: найденными найти
написать: напишите
напряжение: напряжения
настоящий: настоящему
нательный: нательную
начало: начало
невероятный: невероятный
неделя: недели
незабываемый: незабываемых
непростой: непростым
новинка: новинки
новость: новости
новый: новые новым новыми
обещать: обещают
обычный: обычная
один: одним
одиночный: одиночные
одновременно: одновременно
ожидать: ожидает
оказываться: оказывается
опубликовать: опубликован
особый: особой
острый: острых
отличие: отличие
ощущение: ощущение ощущений
палач: палача
первый: первого первым первых
перенести: перенесет
плёнка: пленками
погружение: погружения
погрузить: погрузить
подписаться: подписаться подпишитесь
подписка: подписки
подписчик: подписчикам подписчиков
поезд: поезда
пока: пока
поклонник: поклонников
полицейский: полицейский
положить: положил
получить: получил
пользоваться: пользовался
помнить: помните
популярность: популярностью
потрясать: потрясающее
потусторонний: потустороннее
почитать: почитать
преддверие: преддверии
предлагать: предлагает
предстоять: предстоит
прекрасный: прекрасный
привлекать: привлекая
приквел: приквел
приключение: приключения
примерить: примерить
проводник: проводника
проект: проект проекта проектами
пропустить: пропустите пропустить
просто: просто
прошлое: прошлым
публикация: публикации
пугать: пугающих
радовать: радуют
развернуться: развернется
разработчик: разработчик разработчики
рассказывать: рассказываем
реализм: реализма
реальность: реальности
ребёнок: детям
рекомендовать: рекомендуем
релиз: релиз релиза релизе релизов релизом
ресурс: ресурсов
решение: решении
рок: рока
ролевый: ролевые
ролик: ролики
роль: роль
роман: романа
российский: российские
рыцарь: рыцарей
сервис: сервиса
серия: серия
серьёзный: серьёзную
сеттинг: сеттинге
симулятор: симуляторы
скорый: скорого
следить: следить
снятой: снятые
совместно: совместно
создавать: создают
сочетание: сочетание
способный: способны способные
средневековье: средневековье
стартовый: стартовый
стать: станет станете
статья: статьи
стратегия: стратегии
страх: страха
существо: существами
съёмка: съемки
сюжет: сюжет
тема: темой тему темы
тихо: тихо
травма: травму
трейлер: трейлер
удивить: удивить
ужас: ужасами
ультрареалистичный: ультрареалистичный
упор: упор
управление: управлении
фанат: фанатов
характерный: характерной
хит: хитов
хороший: лучших
хоррор: хоррор хоррора хорроров
центр: центре
часть: части
человек: человека
читать: читали
чудовищный: чудовищными
шутереть: шутер
шутеры: шутеры
экшн: экшн
эмоция: эмоций
эпоха: эпоху
эстетика: эстетикой
этот: этих
эффект: эффект
