айфон: айфон айфона
аккаунт: аккаунт
активный: активное
америка: америкой
андроид: андроидами андроидов андроиды
антагонист: антагонистами антагонистов
арка: арке
армия: армией армию
аудиосистема: аудиосистемы
безграничный: безграничную
безумный: безумные
бесконечно: бесконечно
бесконечный: бесконечное
блеск: блеск
большинство: большинство
бороться: бороться
брать: берет
браузер: браузере
бродить: бродят
будущее: будущем
бывший: бывший
важный: важное важную
вакансия: вакансии
вариант: вариантов
ваш: ваши
весы: весы
весь: всей
взаимодействовать: взаимодействовать
взгляд: взгляд
взглянуть: взгляните
вид: виде виду
видео: видео
видеоигра: видеоигры
виртуальный: виртуального
включать: включала
владелец: владельцев
влиять: влияет
возмутиться: возмутился
войти: войти
вокруг: вокруг
вопрос: вопросами
воспользоваться: воспользоваться
восстать: восставших
вполне: вполне
время: время
вселенная: вселенная вселенной
всё: всё
входить: входят
выбор: выбора
выбраться: выбраться
выдавать: выдают
вынужденный: вынужденной
выступать: выступают
выход: выхода
выходить: выходить
гаджет: гаджеты
галактика: галактики
галактический: галактических
гарри: гарри
геймер: геймер геймеров
гейминг: гейминг
геймплей: геймплеем
героиня: героини
герой: героев героями
гетами: гетами
главный: главная главной
глубокий: глубже
говорить: говорят
годный: годный
головоломка: головоломки
гораздо: гораздо
графический: графические
давать: дает
давно: давно
далеко: далеко
далёкий: дальше
два: две
действие: действие
действительно: действительно
действовать: действуют
демонстрировать: демонстрирует
день: дня
дзен: дзен дзене
дикий: дикой
документ: документы
дополнение: дополнении
достигнуть: достигнет
достижение: достижения
доступный: доступна
друг: друг другом
другой: другие другими другого
душа: души
ещё: ещё
её: её
ждать: ждать
живой: живым
жизнь: жизнь
жить: живут
жнец: жнецы
забавный: забавных
забросить: заброшенном
зависеть: зависит
задаваться: задаются
задать: заданные
задуматься: задуматься
зайти: зайти
запереть: запертой
запрет: запрет
запретить: запрещено
заранее: заранее
заставить: заставила
затем: затем
захватить: захвативших
захватывать: захватывающим
зацепить: зацепят
зверь: звери
земля: землю
знать: знаете
значение: значение
игра: игр игра играх игре игрой игру игры
играть: играет играть
игровой: игровые игровыми
игрок: игрок игрока игроками игроки
идиот: идиот
идти: идет
известие: известий известия
известный: известный
иигровой: иигровой
илона: илон илона
именно: именно
иметь: имеет имеют
инновационный: инновационных
инопланетный: инопланетных
интегрировать: интегрирован
интеллект: интеллект интеллекта интеллекте интеллектом интеллекту
интересный: интересным
интересоваться: интересуются
интернет: интернет
информация: информацию информация
исключение: исключений
искусственный: искусственного искусственном искусственному искусственный искусственным искусственных
использовать: использует
исследовательский: исследовательском
история: истории история
ия: ии
каждый: каждого каждый
казаться: кажется
какой: какие
камера: камеры
канал: канал
картина: картину
каспаров: каспаров
качественно: качественно
кварианец: кварианцы
классический: классическими
книга: книги
колонка: колонки
комментарий: комментариев комментарии
консоль: консоли
контакт: контакты
контролировать: контролируя
контроль: контроля
конфликт: конфликт
концепция: концепция
кортана: кортана
который: которая которого которой которые который которыми
крайне: крайне
критика: критику
кроме: кроме
культовый: культовой
курс: курсе
курьёзный: курьезных
лагерь: лагеря
легендарный: легендарная
лежать: лежит
либо: либо
лицо: лица
личность: личность
любой: любая
макаренко: макаренко
маск: маск
маска: маска
масса: массу
машина: машин машинам
машинный: машинное
менее: менее
менять: меняя
мера: мере
месяц: месяц месяца месяцев
механический: механические механических
мина: мин
минута: минут минута
мир: мира мире миров
миролюбие: миролюбием
миссия: миссия
млечный: млечного
млн: млн
многие: многие
множество: множество
модель: модели
мой: моей
мочь: могут можешь
мужицкий: мужицкая
назад: назад
название: названием
найти: найти
написать: написана
наполнить: наполнен
нарушить: нарушили
насколько: насколько
научный: научной
наушник: наушники
находиться: находится
начало: начало
начинать: начинает начинают
наш: нашу
небольшой: небольшими
невероятно: невероятно
независимо: независимо
неизбежный: неизбежной
нейросеть: нейросетей нейросети нейросеть нейросетью нейросетями
некоторый: некоторые
немного: немного
немой: нем
необученный: необученной
несколько: нескольких несколько
несмотря: несмотря
новость: новости новость
новый: новые
ноутбук: ноутбуки
нужный: нужен
нюанс: нюансы
оба: оба обеих
область: области
обслуживание: обслуживания
обучение: обучение
обучить: обучить
общаться: общаются
общество: общество
общий: общей
обычный: обычные
оглавление: оглавление
ограничение: ограничений
огромный: огромное огромные
один: одна одним
однако: однако
олег: олег
опенсорс: опенсорс
опубликовать: опубликовала
оранжевый: оранжевая
организация: организация
оригинальный: оригинальной
основа: основе
основать: основана
основный: основного основными
особенно: особенно
осознавать: осознавать
осознать: осознать
оставаться: остается остаются
остроумный: остроумных
откомментировать: откомментировал
отличный: отличным
отношение: отношения
отраслевой: отраслевые
отсутствие: отсутствие
отчасти: отчасти
очень: очень
ошибаться: ошибаться ошибаются
ошибка: ошибки ошибок
патриот: патриотами патриоты
первый: первая первое первый первых
персонаж: персонажа персонажей персонажи
печальный: печальную
пик: пика
писать: писало писать
планета: планету
планшет: планшеты
платформа: платформа
племя: племенами
плохой: плохих хуже
повествование: повествования
повод: поводу
повторять: повторяют
погрузиться: погрузиться
подборка: подборке
подобный: подобных
подозревать: подозревают
подопытный: подопытной
подписаться: подписаться подпишитесь
подписка: подписки
подписчик: подписчиков
поиграть: поиграть
пойти: пойдет
пока: пока
показать: показать
полный: полную
пользователь: пользователями
помогать: помогает
понять: понять
пообщаться: пообщалась
порой: порой
портить: портят
посвятить: посвященные
постапокалиптический: постапокалиптическом
постепенно: постепенно
постоянно: постоянно
постоянный: постоянное
потерять: потеряли
почему: почему
почитать: почитать
правда: правду
право: прав права
представить: представлен
представлять: представляют
президент: президента
преимущественно: преимущественно
привлечение: привлечением
приводить: приводят
приключенческий: приключенческий
пример: пример
принимать: принимает принимая
природа: природы
присутствовать: присутствуют
приходить: приходит
причина: причины
пришелец: пришельцами
проблема: проблемой
программист: программисты
проект: проекта проектом проекты
происхождение: происхождении
пройти: пройти
промптов: промптов
пропустить: пропустите пропустить
просто: просто
простор: просторам
противостоять: противостоят
протяжение: протяжении
профессия: профессия
прохождение: прохождения
процесс: процесс процессы
прямо: прямо
психологический: психологический
публикация: публикации
путь: пути
пытаться: пытаются
работа: работе работы
работать: работаю
равный: равные
ради: ради
развернуться: развернутся
развитие: развитие развития
развитой: развитых
разворачиваться: разворачивается разворачиваются
разгораться: разгорается
разделять: разделяет
разный: разными
разработчик: разработчик разработчики
разрушительно: разрушительно
разум: разум
разумный: разумных
раса: рас
раскрываться: раскрывается
рассказать: расскажем
рассказывать: рассказывают
реальный: реальном
ребёнок: детям
режиссировать: режиссируют
реклама: реклама
рекомендовать: рекомендуем
релиз: релизах
реплика: реплик
речь: речь
решать: решать
решение: решением решений решения решениях
робот: робота
родный: родную
ролик: ролики
роль: роль
руководить: руководят
рэмпансия: рэмпансия
сайт: сайт
сам: сами
самый: самый
свобода: свободу
свой: своего свой своя
сделать: сделана
серия: серии серия
серьёзный: серьезные
симуляция: симуляции симуляция
синопсис: синопсис
синтетик: синтетики
сказать: сказать
скрытно: скрытно
слабый: слабее
следить: следить
сложный: сложнее
случай: случаев
случаться: случаются
смартфон: смартфоне смартфоны
смешной: смешные
событие: события
современный: современных
сожаление: сожалению
создание: создание создания
создать: созданный созданными созданных
сообщество: сообщество
сочетаться: сочетается
спойлер: спойлеров
справедливость: справедливость
сражаться: сражаются
сразу: сразу
ссылка: ссылка
сталкиваться: сталкивается сталкиваются
статист: статистов
стать: стали
статья: статье статьи
стелс: стелс
стиль: стиле
стоить: стоит
сторона: стороны
стремительно: стремительно
строиться: строится
стёртый: стертыми
судьба: судьбе судьбу
существо: существ
существование: существовании
сценарий: сценариев
сюжет: сюжет сюжета
сюжетный: сюжетной
тайный: тайная
также: также
такой: такие таких такого
таня: тань таня
татьяна: татьяна
твой: твоем твоих
творение: творениями
текст: текст тексте
текстовый: текстовая текстовых
тема: темой тему темы
технически: технически
технология: технологии
тот: те тех тому
трекер: трекеры
трилогия: трилогии
турнир: турниры
тыс: тыс
тысяча: тысячами
уважение: уважения
увидеть: увидеть
угроза: угроз
узнать: узнает
умный: умные
унижение: унижение
уничтожить: уничтожить
управлять: управляют
управляться: управляется
упрощать: упрощая
упрощённый: упрощенный
факап: факапах
фактически: фактически
фантастика: фантастике
фигурировать: фигурирует
философский: философскими
фитнес: фитнес
фото: фото
фототехник: фототехника
фракция: фракция
франшиза: франшизы
функция: функции
фэнтезийный: фэнтезийная фэнтезийных
хозяин: хозяевами
хорошенечко: хорошенечко
хотя: хотя
цель: цель
центр: центре
центральный: центральную центральный
цивилизация: цивилизация
цикл: циклу
цитата: цитатами
цифровой: цифровую
часто: часто
часть: частью частях
часы: часы
человек: людей люди людьми человек
чемпион: чемпион
черёд: черед
читать: читали
шахматист: шахматистов
шахматный: шахматные
шахматы: шахмат шахматам шахматы
эксперимент: эксперимента эксперименты
экшен: экшен
электроника: электроника
электронный: электронные
элемент: элемент элементы
это: это
этот: этих
юмор: юмором
являться: является
языковой: языковые
яркий: яркий
