абаддон: абаддон
автограф: автографом
аганить: аганим
азарт: азарта
аксессуар: аксессуары
антон: антон
аркан: аркан
арсзика: арсзика
аспект: аспектами аспектов аспектом аспекты
бистмастер: бистмастер
блокбастер: блокбастеры
босс: боссы
брать: берет
бристлбэк: бристлбэк
вакансия: вакансии
ваш: ваш вашего
вдобавок: вдобавок
верить: верил
вернуться: вернуться
взглянуть: взгляните
взять: взять
видео: видео
видеоигра: видеоигры
вместе: вместе
внимание: внимание
водный: водная
возможно: возможно
войти: войти
время: времени время
вроде: вроде
врождёнка: врожденки врожденок
вселенная: вселенные
всё: всё
второе: второе
выиграть: выиграл
выступать: выступал
гайда: гайд
гейминг: гейминг
геймплейный: геймплейные
герой: герой
главный: главная
год: год года
декабрь: декабря
день: дня
деньга: денег деньги
дзен: дзен дзене
дк: дк
добавить: добавили
документ: документы
дополнение: дополнения
дот: дота доте доту
драгоценный: драгоценное
драфтер: драфтеров
другой: другое
дурачьё: дурачье дурачья
ещё: ещё
жалко: жалко
желание: желание
жизнь: жизнью
задержаться: задержаться
занять: занял
запас: запас
записывать: записывать
заявить: заявлено заявлены
золото: золоту
игра: игры
играть: играя
игровой: игровой игровые
инактив: инактив
индустрия: индустрии
интересно: интересно
интересоваться: интересуются
испытывать: испытываю
история: истории
каждый: каждый
канал: канал
карта: карта
карьера: карьере карьеру
керри: керри
кибер: кибер
киберспорт: киберспорт
киберспортсмен: киберспортсмен
клон: клона
коврик: коврика
команда: командой
комментарий: комментарии комментарий
комментировать: комментировать
комплектующие: комплектующие
консоль: консоли
контакт: контакты
контент: контент
копия: копия
кора: кора
который: которую которые
кроме: кроме
крупный: крупных
куча: кучу
лешрак: лешрак
локация: локации
любимый: любимые любимых
любой: любая любую
магнус: магнус
марси: марси
март: марта
массовый: массовые
материал: материале
мейджор: мейджора
место: место
месяц: месяц
механика: механики
мид: мид мида
мина: мин
минута: минут минута минуту
мир: мирах
миран: мирана
млн: млн
многие: многие
многопользовательский: многопользовательские
мобильный: мобильные
надеяться: надеяться
назад: назад
найти: найти
написать: напишите
наслаждаться: наслаждаться
начинающий: начинающих
наш: нашей
невидимость: невидимости
неделя: недели
несколько: несколько
никакой: никакого
новинка: новинки
новоиспечённый: новоиспеченная новоиспеченный
новость: новости
новый: новые новых
обратить: обратить
один: одна одном
одиночный: одиночные
отличный: отличное
официально: официально
оффлейн: оффлейн
очень: очень
патч: патче
патчноут: патчноут
пауза: паузу
первый: первым
перевести: переведен
перерыв: перерыв
планировать: планирую
подписаться: подписаться подпишитесь
подписка: подписки
подписчик: подписчиков
позволить: позволят
позиция: позицию
пока: пока
полный: полный
получать: получает
пост: посте
потратить: потратить
почитать: почитать
поэтому: поэтому
появиться: появится
появление: появлении
приключение: приключения
приносить: приносит
приходиться: приходится
пробовать: пробовать
проводить: проводят
продолжать: продолжаем
пропустить: пропустите пропустить
просто: просто
профессиональный: профессиональная профессиональной
прошлый: прошлом
публикация: публикации
пуджа: пудж
путешествовать: путешествовать
пятёрка: пятерку
разбираться: разбираться
расправить: расправленный
расширение: расширения
ребята: ребята
ребёнок: детям
рекомендовать: рекомендуем
релиз: релизов
решить: решил
розыгрыш: розыгрыш
ролевый: ролевые
ролик: ролики
роль: роль
российский: российские
руно: рун руна
саппорт: саппорт
свой: свои
секунда: секунд секунды
серьёзно: серьезно
сильный: сильный
слардар: слардар
следить: следить
слишком: слишком
собрать: собрали
сокращение: сокращения
сообщить: сообщил
союзник: союзников
спорт: спорт
спортс: спортсе
стать: станет
статья: статьи
стоять: стоят
стратегия: стратегии
стримитя: стримить
студия: студии
суперимбалансный: суперимбалансный
сюрприз: сюрпризы
также: также
телега: телеге
тема: темой тему темы
тихо: тихо
турнир: турнир турниром
тыс: тыс
удовольствие: удовольствия
уйти: ушел
уровень: уровень
усиление: усиления
уходить: уходит
флекситься: флексится
хлопнуть: хлопнули
хороший: лучшие
четверток: четвертку
четвёртый: четвертое
читать: читали
шкредова: шкредов
шутеры: шутеры
экшн: экшн
эффект: эффекты
