адаптироваться: адаптироваться
андеграундный: андеграундных
артефакт: артефакты
бенчмарков: бенчмарков
битва: битву
блог: блога
божественный: божественной божественным
бой: боя
босс: боссам
брать: берут
быть: будут
бюджетный: бюджетных
вакансия: вакансии
ваш: ваш вашего
вводиться: вводиться
великий: величайшую
весна: весны
весь: весь
вечный: вечную
взгляд: взгляд
взглянуть: взглянем взгляните
видео: видео
видеоигра: видеоигры
видеокарта: видеокарт видеокарта
включить: включена
внутренний: внутренняя
внушительный: внушительным
возможность: возможность
войти: войти
восстать: восставшие
враг: врагов
время: временем
вступать: вступают
всё: всё
выбирать: выбирая
выдающийся: выдающимся
выдержать: выдержать
выйти: выйдет вышел
вынести: вынесенного
выпустить: выпустив выпустила выпустить
высокий: высоких
гейминг: гейминг
герой: героев
гигантский: гигантским
главный: главная
гнев: гневом
год: год года году
греховный: греховные
дать: дав
день: дня
деталь: детали
дзен: дзен дзене
добродетельный: добродетельные
документ: документы
должный: должны
доступ: доступа доступе
доступный: доступна
друг: друзей
душа: души
ещё: ещё
железо: железа
жизнь: жизнь
игра: игра играх игру игры
игровой: игровые
игрок: игроки игроков
изменяться: изменяющимся
империя: империю империя
иной: иной
интересоваться: интересуются
интерфейс: интерфейсом
испытание: испытание
история: история
исход: исход
итог: итоге
каждый: каждое
канал: канал
карать: карающим
качество: качества
киберспорт: киберспорт
кино: кино
командный: командной
комедия: комедии
комментарий: комментарии комментарий
комментировать: комментировать
компьютер: компьютеры
контакт: контакты
контроллер: контроллера
контроль: контроль
кооперативный: кооперативный
который: которые которых
кража: кражи
критик: критиков
кроме: кроме
крупный: крупное
лето: лета
лидер: лидером
лишиться: лишились
масштабный: масштабные масштабный
месяц: месяца месяцев
мина: мин
минута: минут минуты
мир: мир мире
млн: млн
многопользовательский: многопользовательские
мочь: могут
награда: наград
назад: назад
название: названием
найти: найти
написать: напишите
настройка: настройках
нацелить: нацелены
наш: нашем
небо: небес
непростой: непростой
несколько: несколько
никита: никита
новинка: новинка
новость: новости
новый: новая новые новый
номинация: номинации
обновление: обновление
один: одну
олегович: олегович
орда: ордами
оружие: оружие
осень: осени осенью
основать: основанный
отвоёвывать: отвоевывать
охватить: охваченном
патч: патча
первый: первое первые первый первым
период: периода
планировать: планируют
платформа: платформ
победа: победа
подборка: подборки
подготовка: подготовки
подписаться: подписаться подпишитесь
подписка: подписки подписку
подписчик: подписчика
позволять: позволяет
пока: пока
показатель: показатели
полноценный: полноценный
получить: получивших
пользовательский: пользовательским
популярный: популярных
посвятить: посвящены
построить: построить
потерять: потеряли
почитать: почитать
пошаговый: пошаговых
право: прав право
представить: представить представлен
предстоять: предстоит
привет: привет
приговор: приговора
признание: признание
приобрести: приобрести
продолжить: продолжим
произведение: произведение
производительность: производительность
пройти: прошли
прокачивать: прокачивать
проклятый: проклятые
пропустить: пропустите пропустить
прославиться: прославилась
протестировать: протестируем
против: против
противостоять: противостоять
проходить: проходить
публикация: публикации
путь: путь
работа: работы
рад: рад
разработать: разработанным
разработчик: разработчики
ранний: раннего раннем
ребёнок: детям
революционный: революционная
рейд: рейды
рейтинг: рейтинги
рекомендовать: рекомендуем
релиз: релиз релиза
рогалик: рогалик
ролевый: ролевая
ролик: ролики
роуглайк: роуглайк
рубль: рублей
сайт: сайте
сбалансировать: сбалансирована
свой: своих своё
сегодня: сегодня
седьмой: седьмой
сервис: сервисе
серия: серии
сила: силам
скриншот: скриншоты
слаженный: слаженной
следить: следить
совершенно: совершенно
совместный: совместными
современный: современных
создать: созданными
специально: специально
список: списком
способность: способности
способный: способную
сравнение: сравнение сравнения
сравнивать: сравнивать
сравнимый: сравним
сражаться: сражаться
сражение: сражение
средне: средне
ссылка: ссылка
стабильный: стабильна
стать: станет станут стать
статья: статьи
стратегия: стратегий
стремиться: стремясь
студия: студии студию студия
судьба: судьбы
также: также
тактический: тактической
талантливый: талантливых
тема: темой тему темы
технический: технические
течение: течение
тихо: тихо
тот: тому
требовать: требует
три: трёх
тусовка: тусовок
убедиться: убедиться
убить: убил
увлекательный: увлекательна
усиливать: усиливающие
усилие: усилиями
условие: условиям
успех: успех успеха
фанат: фанаты
февраль: февраля
функция: функции функциями
хаос: хаоса
характеристика: характеристики
хороший: лучшая
хроника: хроники
церемония: церемонии
цивилизация: цивилизации
часть: часть
число: числе
читать: читали
экшен: экшен
эстонский: эстонская
это: это
этот: эта
