авиапром: авиапрома
автомобильный: автомобильного
аккреции: аккреции
американский: американским
атмосфера: атмосферах
аудиосистемыграфический: аудиосистемыграфические
аэрокомпозит: аэрокомпозит
аэротэк: аэротэк
блогер: блогер блогера
браковать: бракованной
важно: важно
вакансия: вакансии
ватт: ватт
ваш: ваш
ведущий: ведущим
весыколонка: весыколонки
весь: всему
взглянуть: взгляните
видео: видео
видеоролик: видеороликов
видимо: видимо
внушительно: внушительно
вовсе: вовсе
вода: водой
возраст: возраст
вообще: вообще
впервые: впервые
время: время
встретиться: встретятся
встречный: встречный
выйти: выйдут
выпуск: выпуска
выше: выше
газ: газ газа
газовый: газовых
геймер: геймерам
гигант: гигант гиганта
гигантский: гигантских
глубина: глубины
год: года годах году лет
готовить: готовит
графический: графические
день: день дня
десяток: десятков
джеймс: джеймс
дзен: дзен
дзеневакансиидзен: дзеневакансиидзен
доказательство: доказательства
документ: документы
долгий: долгое
должный: должен должным
доллар: долларов
ещё: ещё
замена: замену
заработать: заработало
зафиксировать: зафиксировал
заявить: заявил заявила
земля: земли
игровой: игровой игровые игровых
известный: известный
изображение: изображения
изучение: изучения
индустрииигра: индустрииигры
интересуютсяследить: интересуютсяследить
иск: иск
испытание: испытания
ия: ии
казанец: казанцы
казанский: казанская
канал: канал
карта: карт
китаец: китаец
клиент: клиента
ключевой: ключевого ключевым
книгиновинка: книгиновинки
колонкиотраслевый: колонкиотраслевые
комментарий: комментарий
комментироватьпока: комментироватьпока
компания: компания компаниям
композит: композитов
композитный: композитного
консолиумный: консолиумные
контакт: контакты
конфликт: конфликт
который: которой котором которую которые
критика: критики
крыло: крыла крыло крылом
линейка: линейкой
люксовый: люксового
лёгкий: лёгкое
максимально: максимально
медленный: медленной
менее: менее
мероприятие: мероприятии
месяц: месяца
миллиард: миллиардов
миллион: миллионами миллионов
минкомпания: минкомпания
мир: миру
млн: млн
молодой: молодая
московский: московская
наблюдение: наблюдения
назадподписатьсянепатриотичный: назадподписатьсянепатриотичный
назадподписатьсянеудача: назадподписатьсянеудача
назадподписатьсятелескоп: назадподписатьсятелескоп
найти: найти
наличие: наличие
напрямую: напрямую
неисправный: неисправная
несколько: нескольких
новый: новые
оборудование: оборудование
образ: образом
образоваться: образовались
объект: объектом
оказаться: оказались
около: около
опубликовать: опубликовала
основный: основными
оставаться: оставалась
ответ: ответ
отрасль: отрасли
партнёр: партнёр
первымрекомендовать: первымрекомендуем
период: период
песок: песком
печь: печи печь
планета: планет
подать: подал
подвести: подвели
подписчиковподписатьсязакать: подписчиковподписатьсязачем
подтвердить: подтвердили
позволять: позволяет
показатель: показатели показатель
поколение: поколения
половина: половиной
получить: получив получить
понять: понять
поставить: поставил
потерять: потерять
похвастаться: похвасталась
почему: почему
правда: правда
предоставить: предоставили
представить: представила представили
притягивать: притягивающих
причина: причина
проблема: проблемами
продажа: продажи
продать: продала
проект: проекта проекте
пропустить: пропустите пропустить
прорыв: прорыв прорывом
против: против
проходить: проходили
процессор: процессоры
прямой: прямые
публикациина: публикациине
путём: путём
раз: раза
разгореться: разгорелся
разместить: размещены
разработать: разработала
рамка: рамках
раскритиковать: раскритиковал
расположить: расположенной
репутация: репутацию
рисковать: рискует
российский: российского российское
рубль: рублей
рынок: рынке
самолёт: самолёта
сатурн: сатурн
световой: световых
седан: седана
серия: серию
серьёзный: серьёзными
система: система системы
смотреться: смотрится
совершить: совершил
создание: создании
солнечный: солнечной
составлять: составляет
сравнение: сравнению
сравнивать: сравнивающих
стать: стало станет
стекло: стеклом
столкнуться: столкнулась
сторона: стороны
судекитайский: судекитайский
сумма: сумму
суммарно: суммарно
сценарий: сценарию
твёрдый: твёрдых
телескоп: телескоп
темувидеостатьироликиновостивидеоигрыдетямвсё: темувидеостатьироликиновостивидеоигрыдетямвсё
темувойтиглавнаяподпискинайти: темувойтиглавнаяподпискинайти
темутехнология: темутехнологии
темыгаджет: темыгаджеты
технологииумный: технологииумные
технологический: технологический
тихонаписать: тихонапишите
тот: тому
тыс: тыс
тысяча: тысяч
углекислый: углекислого углекислый
ускоритель: ускорителей ускорители
утверждать: утверждают
уточнить: уточнить
участвовать: участвуя
уэбба: уэбб
ферри: ферри
фиксировать: фиксированной
фирма: фирма
фон: фоне
формирование: формирования
фото: фото
фототехниканаушникиэлектронный: фототехниканаушникиэлектронные
хотя: хотя
четыре: четыре четырём
чип: чипы
число: числе
читать: читали
чёрный: чёрного
экзопланета: экзопланет
экзопланеткосмический: экзопланеткосмический
электроникагеймингнайти: электроникагеймингнайти
это: это
этот: эта
юпитер: юпитер
являться: являются
ядро: ядер
ямка: ямках
