абстрактный: абстрактных
автор: авторов
вакансия: вакансии
вдохновиться: вдохновились
великий: великие
версия: версии
взглянуть: взгляните
взяться: возьмись
видеть: видела
включать: включает
включить: включить
вместо: вместо
внутриигровой: внутриигровым
войско: войсками
волшебный: волшебных
волшебство: волшебство
враг: врагами
время: время
выглядеть: выглядело выглядит выглядят
выявить: выявить
геймингнайти: геймингнайти
генератор: генератор
генерировать: генерировала
герой: героев героя
гибкий: гибкий
глаз: глаза
глянутьответитьизмененорекомендовать: глянутьответитьизмененорекомендуем
год: год года
горо: горо
давать: давайте
дата: дата
движок: движке движок
двухруким: двухруким
делать: делают
день: дня
дзен: дзен
дзеневакансиидзен: дзеневакансиидзен
дневник: дневником
документ: документы
допилить: допилить
достигнуть: достигла
другой: другие других другого
дчестно: дчестно
жизнь: жизни
жизньва: жизньв
заклинание: заклинание
замок: замка замках
запрос: запросах
знать: знает
значительный: значительного
игра: игра игре игры
игрок: игрока
идеально: идеально
известный: известной
иметь: иметь
иначе: иначе
инструмент: инструмент
интересуютсяследить: интересуютсяследить
исключительно: исключительно
каждый: каждое
канал: канал
карта: карт карте
классика: классики
ключевой: ключевые
команда: команда
комментироватьмиша: комментироватьмиша
контакт: контакты
контент: контент
который: которые который
культовый: культовой
лишь: лишь
любопытство: любопытства
магия: магией магии магию магия
месяц: месяцев
механика: механики
меч: мечом
минутдейля: минутдейли
минэнтузиаст: минэнтузиасты
млн: млн
многочисленный: многочисленными
множество: множество
монстр: монстров
мотив: мотивам
мультиплеер: мультиплеер
мыло: мыло
назадподписатьсянейросеть: назадподписатьсянейросеть
найти: найти
нанять: нанять
например: например
невероятно: невероятно
нейросеть: нейросеть
нейтрал: нейтралов нейтралы
нейтральный: нейтральные нейтральных
некоторый: некоторые
нечего: нечего
новый: новые новым
обещать: обещает
обзавестись: обзавестись
обладать: обладают
обмен: обмен
огонь: огнем
один: одной
около: около
оригинальный: оригинальной
основной: основной основные
особенность: особенностях
откуда: откуда
перемещение: перемещение
перенос: переноса
персонаж: персонажей персонажи
планировать: планирует
плохой: худшие
повезти: повезло
поделиться: поделились
поздний: попозже
пока: пока
показать: показала
полностью: полностью
получиться: получилось
попасть: попало
попробовать: попробовали попробую
попытаться: попытались
порассуждать: порассуждаю
порядок: порядка порядок
последний: последние
посмотреть: посмотреть
представить: представили
представление: представления
принимать: принимает
принц: принца
приписать: приписаны
природа: природа природы
прогресс: прогресса
продолжить: продолжим
проект: проект проекта
пропустить: пропустите пропустить
прототип: прототип
прошлый: прошлых
прямо: прямо
публикациина: публикациине
путешествие: путешествий
пять: пять
рабочий: рабочий
развлечение: развлечением
разобрать: разберем разберу разобрал разобрали
разработка: разработки
разработчик: разработчики
разрушениять: разрушенияв
рассмотреть: рассмотрим
расширить: расширить
редакция: редакции
режим: режимы
рейтинговый: рейтинговой
релиз: релиза
ремастер: ремастер
россииработа: россииработы
россия: россии
ряд: ряд
сам: сами
сбалансированный: сбалансированных
сбалансировать: сбалансирована
свой: своего
сгенерировать: сгенерировать
сделать: сделать
серия: серии
сеттинг: сеттинге
сила: силы
сильный: сильна
система: системой
служить: служит
случай: случае
случайный: случайных
смерть: смерти
собственный: собственной собственные
современный: современной
создать: создав
состав: состав
союзник: союзниками
сражение: сражения
среди: среди
статья: статье
стоить: стоило
существо: существ существа
существовать: существуют
также: также
творение: творениями
темувидеостатьироликиновостивидеоигрыдетямвсё: темувидеостатьироликиновостивидеоигрыдетямвсё
темувойтиглавнаяподпискинайти: темувойтиглавнаяподпискинайти
темыстратегия: темыстратегии
тыс: тыс
увидеть: увидел
удобный: удобный
улучшение: улучшений
универсально: универсально
уникальный: уникальной
ускоренный: ускоренные
файтинг: файтинга
фокусник: фокусников
фракция: фракции фракций фракциям
функция: функций
хаос: хаоса
характер: характер
хороший: лучшие лучших
хотеться: хотелось
хотя: хотя
чародей: чародеям
частность: частности
часть: частях
читать: читали
школа: школ школы
экономить: экономящих
элемент: элементы
энтузиаст: энтузиасты
это: это
юнит: юнитами
