активно: активно
анализировать: анализирует
андеграундный: андеграундных
бандит: бандиты
башня: башни
былой: былой
быть: будут
вакансия: вакансии
ваш: ваш
ведущий: ведущей
век: века
версия: версия
весь: весь
взглянуть: взгляните
внутренний: внутренняя
внушительный: внушительным
волк: волк
воссоздание: воссоздания
время: время
вспоминать: вспоминаем
встретить: встретить
встретиться: встретится
второй: второй
выйти: вышел
выпуск: выпуск
выпустить: выпустив
выход: выхода
геймингнайти: геймингнайти
год: год года лет
голова: голову
город: городу
готика: готики
готовить: готовит готовят
далёкий: дальше
данный: данный
дата: дата дату
девблог: девблог
демоверсия: демоверсии демоверсия
день: день дня
держаться: держится
десятка: десятку
деталь: деталями
джиролин: джиролин
дзен: дзен
дзеневакансиидзен: дзеневакансиидзен
дикий: дикая
дневник: дневников
добыча: добычей
документ: документы
дом: доме
домиция: домиций домиция
доран: доран
дорана: дорана дораны
дорановый: доранов
дорога: дороге
достоинство: достоинства
древний: древних
друг: друзей
другой: другим других
жанр: жанра
ждать: ждут
жить: жила
заверить: заверили
завершение: завершение
задержка: задержек
заметка: заметки
захотеть: захотят
игра: игра игру игры
игровой: игрового игровые
игрок: игроков
изучать: изучающие
империя: империя
интересно: интересно
интересный: интересных
интересуютсяследить: интересуютсяследить
исполнить: исполнил
исполняться: исполняется
история: история
итог: итоге
каменный: каменные
канал: канал канале
карта: карту
клятва: клятву
команда: команда
комментарий: комментарий
комментироватьпока: комментироватьпока
контакт: контакты
коррол: корроле
который: которая которые который которых
кража: кражи
критика: критику
ксардас: ксардаса
культовый: культового культовой
легендарный: легендарной
лидер: лидером
лишиться: лишились
лобарт: лобарта
маг: мага
масштаб: масштабами
месяц: месяца
минсегодня: минсегодня
мир: мир мира миров
млн: млн
мнение: мнения
мой: моей мою моё
молодой: молодой
момент: момент момента
мочь: могут
мы: нам
наблюдение: наблюдений
награда: наград награда
надвигаться: надвигающейся
назадподписатьсяистория: назадподписатьсяистория
назначить: назначена
найти: найти
направиться: направился
настолько: настолько
недавно: недавно
недостаток: недостатки
неизвестный: неизвестна
нелинейный: нелинейного
непростой: непростой
несмотря: несмотря
нетерпение: нетерпением
новый: новые новыми
номинация: номинации
обливион: обливионе обливиону
обнаружить: обнаружили
обойти: обойдя
один: одной одну
одобрение: одобрения
оказываться: оказывается
окрестность: окрестностей
опасность: опасности
основоположница: основоположниц
остаться: останусь
отзыв: отзывов отзывы
открытый: открытых
отметить: отметила
отметка: отметке
отсутствие: отсутствии
охота: охота
паладин: паладинов
первый: первой первый
первымрекомендовать: первымрекомендуем
пещера: пещере
победа: победа
поблагодарить: поблагодарив
повествование: повествования
повторить: повторить
подборка: подборка
поделиться: поделится
подписчиковподписатьсясегодний: подписчиковподписатьсясегодня
подход: подходе
пока: пока
полный: полную
получить: полученные
помянуть: помяни
пообещать: пообещав
порождение: порождение
порядок: порядка
потерять: потеряли
право: прав
преданность: преданность
предупредить: предупредить
прекрасный: прекрасна
пробный: пробная
проводить: проводит
проект: проекта проектов
произведение: произведение
пройти: прошли
пропустить: пропустите пропустить
прославиться: прославилась
процесс: процессе
прятаться: прячутся
публикациина: публикациине
публиковать: публиковать
путь: пути путь
работа: работы
работать: работать
разработка: разработки
разработчик: разработчики
ранее: ранее
раскрывать: раскрывают
рассказать: расскажет
релиз: релиз релиза
ремейк: ремейка ремейком
рождение: рождения
ролевый: ролевая ролевой
свежий: свежий
свиток: свитков
свой: свое своем своё
сделать: сделать
сегодня: сегодня
сегодняшний: сегодняшняя
сердцамногопользовательский: сердцамногопользовательские
серия: серии
серьёзный: серьезных
следующий: следующее
слово: слово
собрать: собрала
создание: создания
сообщить: сообщит
состояться: состояться
сотня: сотни
список: списком
спустя: спустя
средне: средне
стать: ставшей стала станет
стоя: стоя
студия: студии студию студия
талантливый: талантливых
тема: темой
темувидеостатьироликиновостивидеоигрыдетямвсё: темувидеостатьироликиновостивидеоигрыдетямвсё
темувойтиглавнаяподпискинайти: темувойтиглавнаяподпискинайти
темыролевый: темыролевые
тихонаписать: тихонапишите
точный: точная
три: трёх
тусовка: тусовок
тыс: тыс
тысяча: тысяч
тёмный: темного
убить: убил убить
указывать: указывать
уровень: уровень
усиленно: усиленно
успех: успех успеха
учесть: учтут
файл: файлы
фанат: фанатов фанаты
ферма: ферма
хориниса: хоринис хориниса
хороший: лучшая
церемония: церемонии
часть: части частям
чета: чета
четвёртый: четвертой
число: числе
читать: читали
чёрный: чёрный
эстонский: эстонская
это: это
