автор: авторов
аксессуар: аксессуары
анализ: анализа
анализировать: анализируют
аналог: аналог
атака: атаки
атмосфера: атмосфера
бесконечный: бесконечные
биологический: биологические биологических
благополучно: благополучно
блаженство: блаженство
блуждание: блужданиям
борт: борту
бррр: бррр
будущее: будущем
быстро: быстро
быть: будут
вакансия: вакансии
валюта: валюту
ваш: ваш
весь: вся
взглянуть: взгляните
видео: видео
видеоигра: видеоигр видеоигры
внутриигровой: внутриигровую
возраст: возрасте
войти: войти
восстановить: восстановить
впервые: впервые
впечатлить: впечатлила
враг: врагами
вселенная: вселенной
вскользь: вскользь
вспоминать: вспоминает вспоминать
вспомнить: вспомнил
всё: всё
второй: второго
вызвать: вызвать
выходить: выходит
галактика: галактику
гейминг: гейминг
главный: главная главной главными
глубина: глубине
говорить: говорит говоря
год: года лет
группа: группе
грядущий: грядущем
давний: давние
дать: данные
дверь: дверей
действие: действия
делать: делали
день: дня
денёк: деньки
десять: десять
дзен: дзен дзене
длительный: длительным
документ: документы
должный: должен
доставить: доставить
другой: другие
ещё: ещё
её: её
жанр: жанру
желание: желаний
железобетонный: железобетонных
жуткий: жуткая
завалить: заваленные
запереть: запертых
засада: засады
затем: затем
заявить: заявлено
звездолёт: звездолётов
звук: звуки
звучащий: звучащие
земля: земли
значение: значение
игра: игр игру игры
играть: играть играя
игровой: игровой игровые
игрок: игроки
идея: идея
избежать: избежать
изображение: изображения
индустрия: индустрии индустрию
интересоваться: интересуются
искать: искать
исполнитель: исполнитель
использование: использовании
исследование: исследование
исследовать: исследовать
история: истории
источник: источники
исчезнуть: исчез
канал: канал
карта: карты
качественный: качественнее
киберспорт: киберспорт
классический: классической
ключ: ключ
книга: книге
колонуть: колони
команда: команды
комментарий: комментарии комментарий
комментировать: комментировать
комната: комнаты
комплектующие: комплектующие
конкретно: конкретно
консоль: консоли
конструкция: конструкций
контакт: контакты
контент: контент контенту
кооперативный: кооперативном кооперативный
корабль: кораблей корабль
коридор: коридоров коридоры
космический: космическая космические космической космическом космическую
космонавт: космонавтов
который: которая которые которым которых
круизный: круизном
куча: кучами
лаборатория: лаборатории
лайк: лайк
лайнер: лайнере
лететь: летят
ликвидация: ликвидации
лишь: лишь
макаренко: макаренко
манящий: манящее
март: марта
материал: материалы
место: место
месяц: месяца месяцев
мина: мин
минута: минут минута
млн: млн
мнение: мнению
многий: многих
многопользовательский: многопользовательские
многочисленный: многочисленных
мобильный: мобильные
монолитовец: монолитовцев
монстр: монстры
мрак: мрак
мурашки: мурашки
мусор: мусора
мутант: мутанты
мы: нам
награда: награду
надежда: надежде
назад: назад
наиболее: наиболее
найти: найти
нападать: нападая
написать: напишите
наполовину: наполовину
населять: населяющие
насколько: насколько
наследие: наследия
научный: научного
начать: начал
наш: наша
недооценивать: недооценивают
необходимо: необходимо
необходимый: необходимую
неосторожный: неосторожных
нестабильный: нестабильный
новинка: новинки
новость: новости
новый: нового новые
объект: объект объекта
обычно: обычно
обязанность: обязанности
огромный: огромном
один: одни
одиночный: одиночные
окутать: окутанная
олег: олег
опасность: опасностей
опасный: опасные
опрос: опрос
осваивать: осваивать
осветить: освещена
основа: основы
основный: основная
особенность: особенностью
особый: особое
осыпаться: осыпающихся
отключение: отключения
отношение: отношение
отправиться: отправиться
отсек: отсеки отсеков
охранять: охранять
оценить: оценить
очень: очень
парень: парней
пасынок: пасынки
первый: первой первым
перевернуть: перевернули
переходить: переходят
питание: питание
планировать: планировать
погружение: погружения
погрузить: погружена погруженной погружены
поддерживать: поддерживает
подписаться: подписаться подпишитесь
подписка: подписки
подписчик: подписчиков
пока: пока
поколение: поколений
получить: получивших получить
помочь: помогите
понравиться: понравившемуся понравилась
посетить: посетите
поставить: поставь
постоянный: постоянные
почитать: почитать
поэтому: поэтому
превратиться: превратятся
прибыть: прибыть
приготовиться: приготовиться
приказ: приказ
приключение: приключения
принять: принято
приобретение: приобретения
пришелец: пришельцы
пробежать: пробежали
проект: проектам
произойти: произошло
пройти: пройти прошёл
проксим: проксиме
пропасть: пропавшую
пропустить: пропустите пропустить
просто: просто
протяжение: протяжении
прохождение: прохождение
публикация: публикации
разговор: разговорах
разнообразный: разнообразные
разумеется: разумеется
распределить: распределить
рассуждать: рассуждает
реагировать: реагируют
реактор: реактор
ребёнок: детям
регулярно: регулярно
рейтинг: рейтинг
рекомендовать: рекомендуем
рекомендоваться: рекомендуется
род: роде
ролевый: ролевые
ролик: ролики
роман: романа
романтик: романтики
российский: российские
свет: свет света
свой: своем свои
связь: связь
сектор: секторов
сеттинг: сеттинге
сильно: сильно
сильный: сильнее
скрип: скрипы
славный: славные
следить: следить
сломать: сломанный
снаряжение: снаряжения
собрать: собрать
собственный: собственного
совместный: совместное
современный: современный современным
содействовать: содействует
создать: создали
соседний: соседней
состоять: состоит
сотня: сотен
социальный: социальные
спонтанный: спонтанные
сталкер: сталкер сталкере
станция: станцией станции станцию станция
стать: станет станут
статья: статьи
стоить: стоит
стратегия: стратегии
страшный: страшное страшные
сформулировать: сформулированы
такой: таких
тема: темой тему темы
темнота: темнотой
тень: тени
тихо: тихо
товарищ: товарищей
точка: точке
тупой: тупых
тусклый: тусклый
тыс: тыс
тьма: тьму
угроза: угроз
узкий: узкие
уметь: умеют
упоминать: упоминают
уровень: уровни
усиливаться: усиливаться
условный: условной
устраивать: устраивая
утерять: утеряна
участник: участников
фоллаут: фоллаута
фонарик: фонарика
хайнлайна: хайнлайна
химический: химических
хороший: хороши
хоррор: хорроре
ценить: ценить
центавро: центавра
часть: часть
четыре: четырех
читать: читали
член: членов
шаг: шаги
шанс: шансов
шип: шип
школьный: школьном
шум: шума
шутеры: шутеры
эвакуация: эвакуации
эвакуироваться: эвакуироваться
экипаж: экипаж
экипировка: экипировка
экшн: экшн
электроэнергия: электроэнергию
это: это
этот: этих
эфир: эфира
эффект: эффект
явно: явно
