абсолютный: абсолютным
автор: авторов
активность: активность
анонсировать: анонсировала анонсирующий
аудитория: аудитории
база: базы
базироваться: базируется
благодаря: благодаря
будущий: будущей
важно: важно
вакансия: вакансии
ваш: ваш
версия: версия
весь: всей всему
взгляд: взгляд
взглянуть: взгляните
видео: видео
видеоигра: видеоигры
визуальный: визуальную
вклад: вклад
включать: включает
внедрять: внедряя
возможность: возможности
войти: войти вошли
воссоздать: воссоздать
время: времен
встретить: встретил
встреча: встреча
всяческий: всяческие
всё: всё
выживание: выживание
выживач: выживач
выйти: выйдет
выпустить: выпустить
выход: выхода
геймер: геймерам геймеров
гейминг: гейминг
геймплей: геймплея
герой: героя
главное: главного
главный: главная
год: год года году
далее: далее
дата: дата
день: дня
деталь: деталь
дзен: дзен дзене
дождаться: дождаться
документ: документы
долгий: долгий
доработка: доработки
достойный: достойными
доступ: доступе
доступность: доступность
дракон: драконы
другой: другие
дыхание: дыхании
ещё: ещё
её: её
жанр: жанра
животное: животные
журналист: журналисты
закалить: закалили
значительно: значительно
значительный: значительные
игра: игр игра игре игрой игру
игровой: игровой
известно: известно
именно: именно
индустрия: индустрии
интересоваться: интересуются
информация: информацию
каждый: каждую
казаться: казался
канал: канал
качество: качество
классический: классическое
ключевой: ключевую
команда: команда
комментарий: комментарии комментарий
комментировать: комментировать
компания: компания
компонент: компонентов
конец: конца
контакт: контакты
кооперативный: кооперативная
который: которая которые который
критерий: критериям
легендарный: легендарной
лишь: лишь
масштабный: масштабной
материал: материале
месяц: месяца месяцев
мина: мин
минута: минут минуты
мир: мире миру
млн: млн
множество: множество
модификация: модификацией
мультиплеерный: мультиплеерную
назад: назад
назвать: назвал назвать
найти: найти
написать: напишите
напомнить: напомнит
наш: наш
нашуметь: нашумевшим
невероятный: невероятное
неизвестно: неизвестно
неизвестный: неизвестна
несколько: несколькими
новинка: новинке новинки
новостной: новостной
новость: новости
новый: новые новый
нуль: нуля
обещать: обещают
огромный: огромной
один: одними одном
одновременно: одновременно
опубликовать: опубликованный
оригинальный: оригинального
оставаться: остается
остров: остров
отметить: отметили отметить
официальный: официальном
оценивать: оценивали
оценить: оценить
очередной: очередной
ощущение: ощущение
первоначально: первоначально
первый: первый первым
переработка: переработку
песочница: песочниц песочницу
планета: планете
платный: платной
племя: племенем
победитель: победителем
подписаться: подписаться подпишитесь
подписка: подписки
подписчик: подписчика
пока: пока
покорить: покорила
полноценный: полноценной
портал: портал
последний: последние
почитать: почитать
появиться: появится
практически: практически
представитель: представителями
предстоящий: предстоящей
привлекательный: привлекательным
продукт: продукта
пройти: прошла
пропустить: пропустите пропустить
процесс: процесс
публикация: публикации
путь: путь
развитие: развитие
различный: различных
разнообразный: разнообразных
разработчик: разработчикам разработчиков
ракьят: ракьят
ранний: раннем
рассказать: расскажем
рассказывать: рассказываем
ребёнок: детям
рекомендовать: рекомендуем
ремейк: ремейк
ролик: ролики
самостоятельный: самостоятельный
самый: самым
сделать: сделав
сердце: сердца
серия: серии
серьёзный: серьезную
сильный: сильнее
системный: системных
следить: следить
смело: смело
смотреться: смотрится
событие: событиями
современный: современной современные
создаваться: создается
создать: создавшая
солнечный: солнечный
составить: составил
составлять: составляющую
сохранить: сохранить
список: список
сразу: сразу
стать: стал стала стало станет
статья: статьи
стиль: стиль
стремиться: стремится
строительство: строительство
студия: студия
существо: существ
считаться: считались
творение: творению
телеграмма: телеграмм
тема: темой тему темы
тернистый: тернистый
технический: технические
тихо: тихо
топ: топ
трагический: трагическими
трейлер: трейлер
третий: третий
тысяча: тысячи
тёплый: теплый
удаться: удалось
узнавать: узнаваемый
улучшение: улучшения
улучшить: улучшив
фанатский: фанатский фанатской
франшиза: франшизы
фэнтезийный: фэнтезийном
хит: хит
хороший: лучших
цель: целью
часть: части
человек: люди
четыре: четырем
читать: читали
шутеры: шутеры
экшен: экшен
экшн: экшн
эльф: эльфы
этот: эта этому
яркий: яркий
