автор: автора
агрессивный: агрессивными
аксессуар: аксессуары
активность: активность
ассасин: ассасинов
атака: атаки
афроамериканец: афроамериканца
близиться: близится близятся
бог: богов
боевой: боевой
больший: большими
бояться: боясь
быстро: быстро
быть: будут
важный: важная важную
вакансия: вакансии
ваш: ваши
век: века
вести: ведёт
весь: вся
взглянуть: взгляните
видео: видео
видеоигра: видеоигры
вновь: вновь
возвращение: возвращение
война: войне
войти: войти вошла вошли
воспоминание: воспоминания
впервые: впервые
вперёд: вперёд
вполне: вполне
вроде: вроде
вступительный: вступительных
всё: всё
вторжение: вторжение
вчера: вчера
выйти: выйдет
выход: выхода
выходить: выходить
выходной: выходные выходных
геймер: геймерами геймеров
гейминг: гейминг
геймплейный: геймплейные
герой: героев
главный: главная
год: года годом лет
громкий: громкие
группа: группу
дата: дата дату
два: двух
девушка: девушки
дело: дела
десяток: десятков
детство: детства
дзен: дзен дзене
добрый: добрыми
документ: документы
дорогой: дорогие
древний: древних
другой: другое
душа: душой
ещё: ещё
жалоба: жалобы
желать: желаю
завести: завела
закон: закону
занять: занять
затаиться: затаиться
защита: защите
защищать: защищать
заявить: заявил
игра: игр игра игры
игровой: игровой игровые
игрок: игроки игроков
идти: идти
издание: издание
иметься: имеется
инди: инди
индустрия: индустрии
инициатива: инициатива
интерес: интерес
интересный: интересные
интересоваться: интересуются
информация: информацию информация
исторический: исторических
история: историю история
канада: канады
канал: канал
киберспорт: киберспорт
команда: команда
компания: компании компания
комплектующие: комплектующие
консоль: консоли
контакт: контакты
континент: континенту
который: которая которые
кроме: кроме
культовый: культовой
купить: купить
личность: личностей
лишь: лишь
любовь: любви
маленький: маленьких
маркетинг: маркетингом
март: марта
материал: материале
мероприятие: мероприятия
место: место
месяц: месяца
метать: метал
методичка: методичке
мина: мин
минута: минут
мир: мира
мишень: мишенью
млн: млн
многое: многое
многопользовательский: многопользовательские
мобильный: мобильные
мочь: могут
мультиплеерный: мультиплеерные
назад: назад
найти: найти
наоэ: наоэ
например: например
наступать: наступающим
начало: начала начале
неделя: недель
недовольный: недовольных
несколько: нескольких несколько
неслабый: неслабый
несмотря: несмотря
ниндзя: ниндзя
новинка: новинки
новость: новости
новый: новая новой новые
обижать: обижать
обязательно: обязательно
ограничиться: ограничились
один: одним
одиночный: одиночные
осень: осени
особо: особо
ответственность: ответственности
отдельный: отдельная отдельную
открытие: открытия
отличие: отличие
отправляться: отправляются
отслеживать: отслеживать
ощущение: ощущениям
первый: первым
перенести: перенесет
подавать: подавать
подборка: подборку
подготовиться: подготовилась
подписаться: подписаться подпишитесь
подписка: подписки
подписчик: подписчиков
подрастать: подрастающего
подтвердить: подтверждённых
пожалуй: пожалуй
пожелать: пожелать
поздравить: поздравить
поиграть: поиграть
поколение: поколения
помощь: помощь
популярный: популярной
последний: последних
постинг: постинга
пострадать: пострадавшими
почитать: почитать
поэтому: поэтому
преддверие: преддверии
предоставлять: предоставлять
предрелизный: предрелизные
представитель: представитель
преследование: преследований преследования
преследователь: преследователей
приветствовать: приветствую
призвать: призвать
приключение: приключения
пример: примером
принести: принесут
продаваться: продающихся
продолжение: продолжение
продуктивный: продуктивными
проект: проекту
пропустить: пропустите пропустить
просить: просят
простой: простых
процветание: процветание
психологический: психологическую
публикация: публикации
пусть: пусть
работа: работы
радость: радость
разворачиваться: разворачивается
разработать: разработали
разработчик: разработчикам разработчиков
ранний: раньше
рассказать: расскажет
расти: расти
реагировать: реагирует
ребёнок: детям
рекомендация: рекомендаций
рекомендовать: рекомендовала рекомендуем
релиз: релиз релиза релизы
решить: решили
рисковать: рисковать
ролевый: ролевые
ролик: ролики роликов
российский: российские
ряд: ряд
самурай: самурая
самый: самых
связь: связь
сделать: сделал
сей: сей
сервис: сервисах
серия: серии
серьёзно: серьёзно
сетевой: сетевые
сеть: сетях
сильный: сильными
симулятор: симуляторы
система: системой
системный: системные
скандал: скандалы
слабый: слабых
следить: следит следить
следующий: следующей следующий
случай: случае случаев
смочь: смогут
снизить: снизить
соблюдать: соблюдать
собрать: собрали собрать
совершать: совершать
сообщать: сообщает
соответствующий: соответствующие
сотрудник: сотрудниками сотрудников
сохранять: сохранять
социальный: социальных
соцсеть: соцсетями
специальный: специальной
стареть: стареть
стать: станет стать
статья: статьи
стелс: стелсом
стратегия: стратегии стратегию
счастие: счастья
сюжет: сюжету
также: также
тамплиер: тамплиеров
тедас: тедас
тема: темой тему темы
топ: топ
требование: требования
тролль: троллей
тыс: тыс
уверенно: уверенно
угрожать: угрожает
указывать: указывать
феодальный: феодальной феодальную
французский: французское
франшиза: франшизы
хороший: хорошие
хотеть: хотел
хэви: хэви
целевой: целевые
целое: целом
целый: целую
час: часов
часть: части часть частью
читатель: читатели
читать: читали
шутеры: шутеры
экшен: экшен
экшн: экшн
эльфийский: эльфийских
эпоха: эпоху
это: это
юрист: юристов
япония: японии японию
яростный: яростных
ясукэ: ясукэ
