администрация: администрация
аксессуар: аксессуары
ассет: ассетов
атака: атак
безумный: безумные
бесплатный: бесплатной
билд: билду
битва: битвы
благодаря: благодаря
боевой: боевую боевыми
борьба: борьбе борьбы
босс: боссами боссов
бросать: бросает
быстрый: быстрые
быть: будут
важный: важной
вакансия: вакансии
вводить: вводили
век: века веков
вестник: вестник
весь: всему
вещь: вещей
взглянуть: взгляните
вид: видов
видео: видео
видеоигра: видеоигр видеоигры
видеоигровой: видеоигровая
видеть: видят
видоигровой: видоигровой
визуально: визуально
владение: владения
вместо: вместо
внимание: внимание
возможно: возможно
возрождение: возрождение
война: войны
войти: войти
вокруг: вокруг
вооружиться: вооружившись вооружиться
враг: врагу
время: времени
вручную: вручную
вряд: вряд
вселенная: вселенная
вспомнить: вспомнить
встреча: встреча встрече
вступать: вступает
всё: всё
выбор: выбора
выжить: выживший
вызов: вызов
выйти: выйдет
выносливость: выносливость
выпустить: выпустив выпустят
высокий: высокого
выходить: выходил выходили
геймер: геймерам
гейминг: гейминг
герой: герой герою героя
гибель: гибель
гигабайт: гигабайт
главное: главного главное
главный: главная главный
глубокий: глубокой
говорить: говорить
год: год лет
гордость: гордость
готовиться: готовимся готовится готовьтесь
дейли: дейли
действие: действие действия
день: дня
держать: держат
десятка: десяткам
деталь: детали
дзен: дзен дзене
днайва: днайв
документ: документы
долгий: долгих
достигнуть: достигли
доступ: доступ
доступный: доступна
другой: другие
европейский: европейские
ещё: ещё
её: её
жанр: жанр жанра
ждать: ждать ждём
задавать: задавая
задумка: задумки
заинтересоваться: заинтересовались
занятный: занятной
запланировать: запланированы
запоминаться: запоминающихся
заявить: заявила
звёздный: звездные звездный
значительный: значительный
игра: игр игра игре игру игры
игровой: игровая игровой игровые
игрок: игрокам игроков
идея: идеей
иметь: имел имели
индустрия: индустрии
институт: института
интересно: интересно
интересный: интересные интересный
интересоваться: интересуются
информация: информация
источник: источник
каждый: каждому
казак: казаки
казаться: кажется
какой: какие
канал: канал
касаться: касается
качество: качестве
квестовый: квестовую
киберспорт: киберспорт
классический: классическую
клацанья: клацанья
клинок: клинком клинок
ключ: ключ
команда: команда команды
комплектующие: комплектующие
компьютерный: компьютерных
конец: конца конце
консоль: консоли
контакт: контакты
концепция: концепции
космический: космическая космический
который: которая которой которую которые который
крепко: крепко
крутой: крутым крутых
культ: культ культом
культовый: культовой
культурный: культурного
легенда: легенды
лицо: лица
лишь: лишь
ловкий: ловкие
локация: локаций
любим: любим
любой: любых
март: марта марте
масштабный: масштабным
материал: материале
машина: машинами
медлительный: медлительные
менее: менее
место: местом
месяц: месяцев
меч: меча мечом
мечник: мечник мечника
мина: мин
минута: минут минуты
мир: мир мира мире
млн: млн
многопользовательский: многопользовательские
множество: множество
мобильный: мобильные
момент: момент
монстр: монстрами
мощный: мощные
мультивселенная: мультивселенная
мышка: мышкой
навык: навыком
надеяться: надеяться
назад: назад
название: названием
найти: найти
наномашина: наномашин
например: например
наследие: наследия
насыщенный: насыщенных
находить: находить
начало: начало
начинающий: начинающие
некоторый: некоторые
необходимо: необходимо
несколько: нескольким
никто: никто
новинка: новинке новинки
новость: новости
новый: новые
нужно: нужно
обзор: обзор
обращать: обращать
объект: объекту
оглавление: оглавление
один: одна одним
одиночный: одиночные
одиссея: одиссея
оказаться: оказались
он: нём
они: ними
опера: опера
орудовать: орудуя
основа: основе
особенно: особенно
оставаться: остаётся
оставить: оставила
ответ: ответе
отзыв: отзывов
отменный: отменный
очень: очень
парирование: парирований
первый: первая первого первые первых
перекат: перекатов
пик: пика
пк: пк
плюс: плюс
победить: победить
погружать: погружающая
подкачать: подкачает
подписаться: подписаться подпишитесь
подписка: подписки
подписчик: подписчиков
подробно: подробно
подробный: подробнее
подход: подход
поздний: позже
поиграть: поиграть
пока: пока
показать: показать
полноценный: полноценному
получить: получила
пользователь: пользователям
помимо: помимо
помнить: помним
помочь: помочь
помощь: помощью
популярность: популярности популярность
последний: последних
постапокалиптический: постапокалиптическая постапокалиптический
потенциал: потенциал
поучаствовать: поучаствовать
почитать: почитать
появиться: появился
правда: правда правдой
предложить: предложит
представлять: представляющий
предстоять: предстоит
предстоящий: предстоящей
привычный: привычного привычный
приготовить: приготовили
прийтись: придётся
приключение: приключения
примечательный: примечательную
приобрести: приобрели
приставка: приставка
приятно: приятно
продаваться: продаётся
проект: проект проектов
пройти: пройти
пропустить: пропустите пропустить
протагонист: протагонист
профессиональный: профессиональные
прочий: прочие
проявить: проявить
публикация: публикации
путь: путь
пятнадцать: пятнадцать
разнообразный: разнообразные
разный: разных
разработка: разработки
разработчик: разработчик разработчики разработчиков
разрушить: разрушил
рано: рано
раскручивать: раскручивал
рассказать: рассказать
рассказывать: рассказывают
реализация: реализация
реальный: реальном
ребёнок: детям
рекомендовать: рекомендуем
релиз: релиз релизе релизу
решить: решили
робот: роботов
ролевый: ролевые
ролик: ролики
российский: российские
россия: россия
русский: русская русских русского
сам: самого
самый: самые самым
сбрасывать: сбрасывать
свой: своей своих свой
сделать: сделали сделают
себя: собой
секрет: секрете
секретность: секретности
сериал: сериал
серия: серии
серьёзно: серьёзно
симулятор: симуляторы
система: системе систему
скриншот: скриншота
след: след
следить: следить
слиться: слились
сложный: сложными
слух: слухи слухов
слышать: слышали
собрать: собрать
согласно: согласно
сообразительность: сообразительность
соткать: соткали
специальный: специальные
способность: способности
сражение: сражений сражения сражениям сражениях
сразу: сразу
срок: сроков
сталкер: сталкера
стать: стала стали станет
статья: статьи
стоить: стоит
столкнуться: столкнуться
страна: страны
странный: странная
стратегия: стратегии стратегия
структура: структуру
студент: студенты
стычка: стычек
судить: судя
существовать: существуют
счёт: счетов
сюжет: сюжету
тема: теме темой тему темы
терминатор: терминатор
терять: теряет
тестирование: тестирования
технологический: технологического
технология: технологии
топ: топ
традиция: традициям
трейлер: трейлер трейлеру
тропа: тропе
тыс: тыс
тёмный: тёмного
удивить: удивить
узнать: узнать
уйти: ушедшей
уклад: уклад
уклонение: уклонений
украсть: украли
умопомрачительный: умопомрачительный
уникальный: уникальных
уровень: уровень уровня
учиться: учащиеся
фантастический: фантастические
фильм: фильмы
фэнтези: фэнтези
хакер: хакеры
характерный: характерный
ходить: ходит
хороший: лучшая
цеплять: цепляющий
цепочка: цепочку
часто: часто
часть: частей частью
читать: читали
шесть: шесть
широкий: широкую
шутеры: шутеры
экономический: экономической
экшн: экшн
эпоха: эпохи эпоху
это: это
этот: эта
юмор: юмор
язык: языка
