адепт: адептам
аксессуар: аксессуары
аниме: аниме
антигерой: антигерой
аудио: аудио
аудиодизайнер: аудиодизайнер
баланс: балансом
безусловно: безусловно
благодаря: благодаря
боевой: боевому
бой: боя
больший: большим
большинство: большинства большинство
будни: будни
быть: будут
важно: важно
важный: важна
вакансия: вакансии
вариант: вариантов
вариативность: вариативность
ваш: ваш
вдохновить: вдохновлены
великий: величайшего
вера: вера
вещь: вещи
взгляд: взгляд
взглянуть: взгляните
видео: видео
видеоигра: видеоигры
видеть: видят
внести: внёс
возможность: возможностей возможности возможность
воин: воинов
войти: войти
враг: врагов
время: времена
вселенная: вселенной вселенные
всё: всё
вчера: вчера
вы: вами
выглядеть: выглядеть
выйти: вышли
выполнить: выполненных
выпуск: выпуске
выпустить: выпустила
высаживаться: высаживаются
выходка: выходками
галактика: галактики
гейминг: гейминг
герой: героев герои героя героях
главное: главное
главный: главная главных
глубокий: глубокую
говорить: говорить
год: год года годами
голосовой: голосовом
гонщик: гонщика
давать: давайте
данный: данный
дар: дар
дать: дать
девблог: девблоге
действительно: действительно
дзен: дзен дзене
дикий: дикой
динамический: динамической
добро: добро
довольно: довольно
доказывать: доказывали
документ: документы
должный: должны
достаточно: достаточно
достать: достал
достигнуть: достигла
другой: другие
дс: дс
думать: думаю
дэд: дэд
дэдпул: дэдпул
ещё: ещё
живопись: живописи
жизнь: жизнь
закулисный: закулисный
занимать: занимают
затмить: затмить
зацикленный: зацикленные
звуковой: звукового
знать: знаете знают
зрение: зрения
ибо: ибо
игра: игрой игры
играть: играть
игровой: игровой игровые
известный: известна известное
изначально: изначально
имбалансный: имбалансных
именно: именно
иметь: имея
индустрия: индустрии
интересный: интересным интересных
интересоваться: интересуются
исказить: искажена
использовать: использовать
история: истории
итог: итоге
каждый: каждого каждому
казаться: кажется
кампания: кампания
канал: канал
карикатурист: карикатуриста
касаться: касается
кельтский: кельтскими
киберспорт: киберспорт
класс: класс
количество: количество количеством количеству
колорит: колорит
команда: команда
комикс: комиксов
комментарий: комментарии комментарий
комментировать: комментировать
комплектующие: комплектующие
консоль: консоли
контакт: контакты
корабль: корабли кораблях
коротышка: коротышек
космический: космические космических
который: которой которые которых
крыло: крыльев крылья
курт: курт
ларсон: ларсон
легко: легко
летать: летать
либо: либо
лига: лига
линия: линии
лиса: лиса
лишь: лишь
любить: любите
любопытный: любопытная
маг: магов
магический: магический
магия: магии
маленький: маленькими
мана: маны
марафон: марафон
марвести: марвел
мастер: мастер
медиа: медиа
мера: мере
местность: местности
место: место
месяц: месяца месяцев
мина: мин
минута: минут минуты
мир: мира мире миру миры
миф: мифами мифы
млн: млн
многопользовательский: многопользовательские
мобильный: мобильные
момент: момент
мочь: могли могут
мощь: мощью
музыка: музыка музыке музыки музыкой
мы: нам
наверняка: наверняка
назад: назад
наземный: наземные
найти: найти
написать: напишите
наполнять: наполняет
нарутоподобный: нарутоподобных
научно: научно
начало: началом
начать: начнём
наёмник: наёмник
небольшой: небольшую
некоторый: некоторые некоторым
неоднократно: неоднократно
несколько: несколько
нести: несли
неуязвимый: неуязвимый
новинка: новинки
новость: новости
новый: новое новую новые новый
нога: ног
нужно: нужно
обделить: обделили
обученный: обученных
огромный: огромной
один: одни
одиночный: одиночные
однажды: однажды
однако: однако
озвучка: озвучки озвучкой
определиться: определилась
опыт: опыт опыту
основной: основной
остановиться: остановилась
отжигать: отжигает
открыть: открыв
отметка: отметки
очень: очень
очередной: очередной
ощущение: ощущения
паук: паука
паучок: паучком
первый: первым первых
перегрузить: перегруженной
передать: передать
перекатить: перекаченных
персонаж: персонажа персонажей персонажем персонажи
план: планов
побеждать: побеждают
поговорить: поговорить
поговорка: поговорка
погода: погоду
погружение: погружение
подавлять: подавляющему
подобный: подобные подобными
подписаться: подписаться подпишитесь
подписка: подписки
подписчик: подписчиков
пожаловать: пожаловать
позволить: позволили
пойти: пошло
пока: пока
получить: получить
польза: пользу
пользоваться: пользоваться
помогать: помогает
популярность: популярности
популярный: популярным
порой: порой
посещать: посещает
последний: последнем
посмотреть: посмотрим
потусторонний: потустороннего
почитать: почитать
появляться: появляется появлялись
предел: предел
представить: представила представили
прекрасно: прекрасно
придать: придать
призрачный: призрачного
приключение: приключения
приколист: приколиста
пробираться: пробираются
пропустить: пропустите пропустить
просто: просто
процесс: процессе
прояснить: прояснить
прятаться: прячутся
публикация: публикации
работать: работают
развивать: развивая
развиваться: развивались
разделить: разделены
различаться: различаются
различный: различных
размер: размер размеру
разнообразие: разнообразие
разный: разные
разработка: разработки
раса: расу
рассказать: рассказать
рассказывать: рассказывает
рассмотреть: рассмотрено
реагировать: реагировала
реалист: реалист
реальный: реальной реальному
ребёнок: детям
резкий: резких
рекомендовать: рекомендуем
религиозный: религиозным
реплика: реплики
родина: родиной
ролевый: ролевой ролевые
ролик: ролики
российский: российские
самый: самое
свой: свои своими своих свой
сегодня: сегодня
сервитор: сервиторах
серия: серию
сеттинг: сеттинге
сила: сила силу
сильный: сильных
симулятор: симуляторы
слабый: слабый
следить: следить
слышать: слышали
смочь: смогли
смысл: смыслах
снова: снова
собираться: собираются
собственный: собственные собственный
создание: создание создания
создатель: создатели
сопровождение: сопровождении сопровождения
сочетание: сочетании
сразу: сразу
стать: стали станет статей
статья: статьи
стиль: стилях
стража: стражами стражей
стратегия: стратегии
строить: строят
судить: судя
суметь: сумел
существовать: существуют
сцена: сцену
считать: считает считают
сюжет: сюжетов
сюжетный: сюжетной
тайна: тайн тайну
также: также
такой: таких
талантливый: талантливых
творчески: творчески
тема: темой тему темы
тир: тир
тихо: тихо
тот: те
точка: точки
традиционный: традиционные
транспланетарный: транспланетарная
трек: треки
три: трёх
троица: троицу
тыс: тыс
увидеть: увидеть
уйти: уйти
ум: ума
умение: умение
умник: умников
уникум: уникумах
условие: условия
установить: установить
уступать: уступают
участвовать: участвует
фантастический: фантастическом
фееподобный: фееподобную
фейри: фейри
физически: физически
фон: фоне
фоновый: фоновой
фэйри: фэйри
хотеть: хотела хотите хочу
хотеться: хочется
хотя: хотя
художник: художник
центральный: центральное центральных
человек: человека
человеческий: человеческих
человечный: человечными
черта: черт
читать: читали
шутеры: шутеры
шутливый: шутливая
эволюционировать: эволюционирующим
экшн: экшн
эльф: эльфов эльфы
эмоциональный: эмоциональный
это: это
этот: эта
юмор: юмор
являться: является
японец: японцы
