аккаунт: аккаунт
без: безо
безлюдный: безлюдных
бесплатно: бесплатно
бесплатный: бесплатными
больший: большей
быть: будут
вакансия: вакансии
ваш: ваш
вдохновить: вдохновлённый
верить: верит
взгляд: взгляд взгляда
взглянуть: взгляните
внешний: внешний внешним
возможность: возможностями
возникнуть: возникла
востребовать: востребованных
время: время
всякий: всяких
выйти: выйдут
выпустить: выпущена выпущены
говорить: говорим
год: год году лет
готовить: готовят
графика: графике графикой
два: двух
движок: движков
делать: делать делают
день: день дня
дзен: дзен
дзеневакансиидзен: дзеневакансиидзен
дитя: дитя
длительный: длительное
доказательство: доказательство
документ: документы
дополнительный: дополнительных
доступный: доступна
её: её
желание: желание
жить: живем живут
забрать: забрать
забытый: забытых
завоевать: завоевать
захватывать: захватывающими
знакомый: знакомую
игра: игр игра играми игры
игровой: игровой игровые игровых
игрыроссийский: игрыроссийские
игрыэкшн: игрыэкшн
идти: идёт
известно: известно
иметься: имеется
индустрииигра: индустрииигры
индустрия: индустрии
инновационный: инновационные
инсайдер: инсайдерам
интересуютсяследить: интересуютсяследить
исключение: исключением
история: историю
какой: какие
кан: кан
канал: канал
киберспортодиночный: киберспортодиночные
киноамнезия: киноамнезии
клэр: клэр
комментарий: комментарий
комментироватьпока: комментироватьпока
компания: компании
комплектующиешутерымногопользовательский: комплектующиешутерымногопользовательские
консолиновинка: консолиновинки
контакт: контакты
который: которого которое котором которые которых
культовый: культовой
леона: леона
любовь: любовь
магазин: магазин
март: марта
менее: менее
месяц: месяцев
мина: мин
минутретрогеймер: минутретрогеймер
минутыигра: минутыигры
минутыигров: минутыигровой
мир: мир мире миров миром
млн: млн
многий: многих
множество: множество
мощный: мощных
мы: нам
навсегда: навсегда
назад: назад
назадподписатьсякакий: назадподписатьсякакие
назадподписатьсяремейка: назадподписатьсяремейки
назадподписатьсятоп: назадподписатьсятоп
найти: найти
напоминать: напоминают
напомнить: напомню
немногое: немногим
новый: новые новый
обзор: обзоре
огромный: огромное
онагой: онага
осовременятхорошо: осовременятхорошо
отдавать: отдаёт
отличаться: отличаются
очередной: очередное
первый: первого
первымрекомендовать: первымрекомендуем
перезапуск: перезапуском
план: планы
плохо: плохо
подробный: подробнее
подход: подходы
поздний: позже
пользователь: пользователей пользователям
постоянно: постоянно
правило: правил
предлагать: предлагает предлагаю
представитель: представители
представлять: представляет
привет: привет
пример: примеру
продолжать: продолжает
проект: проект
пропустить: пропустите пропустить
пространство: пространство
протяжение: протяжении
публика: публики
публикациина: публикациине
пустошь: пустошей
работать: работать работают
радовать: радовать
развивающийся: развивающиеся
разнообразный: разнообразные
разработчик: разработчики
раса: рас расы
рассмотреть: рассмотреть рассмотрим
реалистичный: реалистичной реалистичными
рейтинг: рейтинг
ремейк: ремейках ремейки ремейков
ролевый: ролевой ролевые
россия: россии
самый: самые самых
свой: своими
себя: собой
сегодняшний: сегодняшней сегодняшний
сей: сей
серия: серией серии серия
сеть: сеть
сильно: сильно
слить: слиты
сместить: сместил
смочь: смогла
составлять: составляет
состоять: состоит
стать: стали стало станет
статья: статье
стратегия: стратегии
субъективный: субъективном
существовать: существуют
тема: темой
темувидеостатьироликиновостивидеоигрыдетямвсё: темувидеостатьироликиновостивидеоигрыдетямвсё
темувойтиглавнаяподпискинайти: темувойтиглавнаяподпискинайти
темуигровой: темуигровые
технология: технологии
тихонаписать: тихонапишите
топ: топ
тот: тому
тыс: тыс
удивлять: удивлять
узнаваться: узнаётся
упомянуть: упомянуть
хардкорный: хардкорный
часть: части часть
человек: людей
читать: читали
шао: шао
шесть: шести
экшен: экшен
эпоха: эпоху
это: это
