автор: автор авторов авторы
активно: активно
аудитория: аудиторию
вакансия: вакансии
ваш: ваш
вдохновляться: вдохновлялись
взглянуть: взгляните
взяться: взялись
видеоигра: видеоигры
влиять: влияет
вместе: вместе
внести: внести
возможность: возможность
впечатление: впечатления
временной: временных
время: времен времени время
второй: вторая второй
выйти: вышедшей вышла
выпустить: выпустит
высокий: высокого
геймплей: геймплей
говард: говард
год: год года году лет
дата: дата дату
дать: дать
два: двух
действие: действие
декабрь: декабря
день: дней дня
дзен: дзен
дзеневакансиидзен: дзеневакансиидзен
дилогия: дилогии
длительный: длительном
добавить: добавит
документ: документы
долгий: долгого
достаточно: достаточно
доступ: доступ доступа
доступный: доступен
дписчиковподписатьсяследующий: подписчиковподписатьсяследующее
ждать: ждать
зарубежный: зарубежной
знать: знать
зона: зону
игра: игра игре игрой игру игры
игровой: игровой игровые игровых
игрок: игрокам игроков
игрыроссийский: игрыроссийские
игрыэкшн: игрыэкшн
известный: известном известную
изменение: изменений
изменить: изменит
измениться: изменится
индустрииигра: индустрииигры
интересуютсяследить: интересуютсяследить
информация: информацию
исследовать: исследовать
источник: источник
каждый: каждого
какой: какие
канал: канал
карта: карту карты
киберспортодиночный: киберспортодиночные
книга: книги
коллектив: коллектива
команда: команда
комментарий: комментарий
комментироватьпока: комментироватьпока
комплектующиешутерымногопользовательский: комплектующиешутерымногопользовательские
конец: конце концу
консолинайти: консолинайти
контакт: контакты
контент: контент
который: которая которым
критиковпервые: критиковпервые
крупный: крупное
культовый: культовой
купить: купить
лицензия: лицензии
любой: любую
март: марта
материал: материале
месяц: месяц месяца
механик: механик
механика: механики
минигрок: минигроки
мир: мире
младший: младше
млн: млн
мнение: мнения
назадподписатьсяглавный: назадподписатьсяглавное
назадподписатьсякак: назадподписатьсякак
назадподписатьсяобзор: назадподписатьсяобзор
название: названием
найти: найти
наступление: наступления
некоторый: некоторые некоторых
неоптимальный: неоптимальном
неполноценный: неполноценным
несколько: несколько
нехватка: нехватки
новичок: новичка новичкам новичков
новый: новая новой новую новые новый
нужно: нужно
обеспечить: обеспечить
область: области
обновление: обновление обновлении
обрести: обрела
один: одни одну
одновременно: одновременно
они: ними
опасение: опасения
определённый: определенные
оригинал: оригинала
основа: основу
отзыв: отзывов отзывы
открывать: открывает
открыть: открыт
относиться: относящихся
оценка: оценки
патч: патче
первый: первая первые первых
первымрекомендовать: первымрекомендуем
перенести: перенесены
переноситься: переносятся
персонаж: персонажа
пк: пк
планировать: планируем
повлиять: повлияли
повод: поводу
повышенный: повышенной
подземелье: подземелий подземелья подземельям подземельями
поздний: поздней
поиграть: поигравших
показаться: показался
полностью: полностью
получить: получила получили
последний: последней последние
поспешный: поспешным
похоже: похоже
почему: почему
появиться: появились появятся
правило: правило
предназначить: предназначен
пресса: прессы
придумать: придумал
прийтись: пришлось
проблема: проблемы
продвинуть: продвинутых
продолжительность: продолжительности продолжительность
проект: проект
пройти: пройти
пропустить: пропустите пропустить
простой: простое
прохождение: прохождения
прочее: прочее
публика: публики
публикациина: публикациине
пять: пять
разблокирование: разблокирования
разблокировать: разблокированный
разблокировка: разблокировки
развитие: развитии
разворачиваться: разворачивается
разный: разных
разработчик: разработчики
ранний: раннего раньше
рассказывать: рассказываем
расширять: расширяет
режим: режим режиме
релиз: релиза
ремейк: ремейк
решить: решили решить
ролевый: ролевая ролевые
россиивсе: россиивсе
рост: роста
свой: свой
сезон: сезона
середина: середине середины
сериал: сериала
серия: серии
сеть: сети
сиквел: сиквел
симулятор: симуляторы
системный: системные
скандальнымтекст: скандальнымтекст
скорректировать: скорректировать скорректирует
скорый: скорого
слабый: слабом
следующий: следующее
слишком: слишком
сложность: сложности
собрать: собрать
современный: современный
создать: создала
сократиться: сократятся
соответственно: соответственно
способность: способность
справляться: справляться
средний: средней
старт: стартом
статус: статус
стать: стала станет
стратегия: стратегии
студия: студии студия
схожий: схожие
сценарий: сценарии сценария сценариях
сценарный: сценарных
сюжет: сюжет
сюжетный: сюжетную
также: также
такой: таких
тема: темой
темп: темпе
темувидеостатьироликиновостивидеоигрыдетямвсё: темувидеостатьироликиновостивидеоигрыдетямвсё
темувойтиглавнаяподпискинайти: темувойтиглавнаяподпискинайти
темуновинка: темуновинки
темыгеймингигровый: темыгеймингигровые
течение: течение
тихонаписать: тихонапишите
тодда: тодд
требование: требования
трейлер: трейлер
третий: третьей третья
три: трех
трёхмерный: трехмерная
тыс: тыс
удалить: удалена
удивительно: удивительно
уровень: уровни уровня
услышать: услышаны
успех: успехом
устранить: устранить
фаза: фаз фаза фазах фазу фазы
февраль: феврале
фильм: фильмы
фон: фоне
франшиза: франшиза
фэнтезийный: фэнтезийном фэнтезийную
часть: частей
четвёртый: четвертой четвертую
четыре: четыре четырех
читатель: читателей
читать: читали
шведский: шведские
шесть: шести
широкий: широкий
экранизация: экранизацию
эксклюзив: эксклюзивом
эндгейм: эндгейм эндгейма
эор: эора
этап: этапа
это: это
этот: этих
