автор: авторы
авторский: авторским
агрегатор: агрегаторам агрегаторы
адреналин: адреналина
аксессуарымобильный: аксессуарымобильные
аналоговый: аналоговой
антитоп: антитопов
атака: атак атаке атаки
атмосферный: атмосферное
ах: ах
баланс: баланс
бежать: беги
беситься: беситься
бесконечный: бесконечную
битва: битва
бить: бьют
блогер: блогеры
блокировать: блокировать
бой: бой
большинство: большинства
большой: большой большому
босс: боссом боссы
брат: брату
бросать: бросает
бросить: бросить
бурчать: бурчать
бывать: бывает
быстро: быстро
быстрый: быстрее
быть: будете будут
вакансия: вакансии
вариант: вариант
ваш: ваш вашего вашей вашему ваши ваших
вводить: вводить
вдвоём: вдвоём
великолепный: великолепна
вероятно: вероятно
верх: верх
весело: весело
весь: всем
взглянуть: взгляните
взять: взять
видеть: видим
визуальный: визуальные
вкратце: вкратце
влупить: влупить
внимание: внимание
внимательно: внимательно
вода: воды
возвращаться: возвращаться
воздействие: воздействие
возможно: возможно
возможность: возможности
возможный: возможен
вознаградить: вознаграждены
восстановить: восстановить
впервые: впервые
враг: враг врагами враги врагов
врать: вру
время: времени время времён
вряд: вряд
вспомнить: вспомним
всё: всё
входящий: входящие
вы: вами
выброс: выброс
выверить: выверены
выводить: выводили
вызвать: вызвали
вызов: вызов
вылить: вылили
выносливость: выносливости
выполнить: выполненного
вытерпеть: вытерпите
геймпад: геймпадом
геймплей: геймплей
геймплейный: геймплейно
герой: герои
главный: главные
глаз: глазу
глотательный: глотательных
глубина: глубина глубину
говорить: говоря
год: года годов
годать: годав
голова: головах головой
головокружительный: головокружительного
гонка: гонках гонок
гоночный: гоночные гоночных
готовиться: готовится
графика: графика
графический: графическим
громкий: громкими
давать: дает
далеко: далеко
данный: данную данный
дарк: дарк
два: две
двадцатый: двадцатый
двигаться: движется
действительно: действительно
действо: действо
делать: делает делать
дело: деле дело
день: дня
дзен: дзен
дзеневакансиидзен: дзеневакансиидзен
дизайн: дизайном
доверять: доверять
довольный: довольны
документ: документы
долг: долга
должный: должна должны
достигнуть: достигнута
достойный: достойных
доступ: доступ
доступно: доступно
доступный: доступна доступных
друг: другу
другой: другие других
думать: думал думать
дух: духе
душа: душ
дьявол: дьявола
единственный: единственный
ещё: ещё
ещёбольшинство: ещёбольшинство
её: её
жанр: жанра
ждать: ждите ждёт
жевательный: жевательных
жена: жене
жестокий: жесток жестокое жестокой
жизнь: жизни жизнь
забавный: забавная забавные
заблуждение: заблуждение
заботиться: заботится
заинтересовать: заинтересует
закончить: закончат
заметить: заметили
запускать: запускаете
заставить: заставит заставят
заставлять: заставляет
затратить: затраченной
зачастую: зачастую
защитный: защитные
заявить: заявить
здоровье: здоровье здоровья
злотый: злотых
знать: знать
значит: значит
ибо: ибо
игра: игр игра играм играми играх игре игру игры
играть: играете играли играть играю
игровой: игровой
игрожур: игрожуры
игрок: игроки игроков игроком
игрушка: игрушки
игрыигровой: игрыигровые
игрыэкшн: игрыэкшн
идея: идея
избегать: избегать
известный: известным
издание: издания
изменять: изменять
изначально: изначально
именно: именно
иметь: имеет иметь имеют
интересный: интересной интересный
интересуютсяследить: интересуютсяследить
испытание: испытание испытаний
испытать: испытать
исход: исходом
итог: итоге итоги
ия: ии
каждый: каждая
казаться: кажется казалось
какой: какие
канал: канал
карма: карма
картинка: картинка
карьера: карьеру
категория: категориям
киберспортигровый: киберспортигровые
киноамнезия: киноамнезии
кишеть: кишит
кнопка: кнопке
комбо: комбо
комментарий: комментариях
комната: комнату
комплектующиестратегия: комплектующиестратегии
конец: конца конце
конечный: конечном
конкурент: конкуренты
консолиодиночный: консолиодиночные
консоль: консоли
константинович: константиновичей
контакт: контакты
контент: контент
контроллер: контроллер
который: которая котором которые который которых
красивый: красивая
критика: критику
кроме: кроме
круг: кругу
кружка: кружками
кто: кого
легко: легко
лига: лиги
лицо: лица
лишаться: лишаться
лишь: лишь
лишённый: лишенные
любезничать: любезничать
любимый: любимых
любитель: любители
любить: любите
любой: любая любой
люцифер: люциферов
лёгкий: легкая легче лёгкой
лёт: лету
мало: мало
манёвр: маневру
мартава: мартавы
мартаконечный: мартаконечно
материал: материалом
медаль: медаль
мера: мере
место: месте
месяц: месяц
метроидвания: метроидваний метроидвания
механика: механикой
мимо: мимо
миноглавлениесложный: миноглавлениесложные
минутигровый: минутигровой
минутыигра: минутыигры
мир: мир
млн: млн
мнение: мнение
многие: многие
многий: многих
многопользовательский: многопользовательские
множество: множество
момент: момент
мочь: могу могут можете
музыка: музыка
мягко: мягко
наверняка: наверняка
навредить: навредить
навык: навыки
нагрузка: нагрузки
надеяться: надейтесь надеюсь
назадподписатьсяантирейтинг: назадподписатьсяантирейтинг
назадподписатьсяпочий: назадподписатьсяпочему
найти: найти
нанести: нанести
напортачить: напортачите
насилие: насилия
наслать: нашли
настигнуть: настигнет
настоятельно: настоятельно
настоящий: настоящий
наступательный: наступательные
научиться: научиться
находиться: находитесь
начало: начала
начать: начать
начинать: начинает
наш: нашей наших
небольшой: небольшую
невероятно: невероятно
невозможно: невозможно
недовольство: недовольство
незабываемый: незабываемые
неиграбельный: неиграбельна
неимоверный: неимоверные
некоторый: некоторых
немного: немного
неправильно: неправильно
непревзойдённый: непревзойденную
неприлично: неприлично
неприятный: неприятным
непроходимый: непроходимых
нерв: нервы
несколько: несколько
несомненно: несомненно
нестись: несетесь
неудача: неудачей
нехватка: нехватке
никакой: никакого
ниоха: ниоха
новый: нового новые
нужно: нужно
облегчение: облегчение
облегчить: облегчил
обратить: обратили
общество: обществе
обычный: обычных
обязательно: обязательно
обязательный: обязательным
овладеть: овладеете
огромный: огромное
одержать: одержать
один: одна одни одной
одиночный: одиночных
однако: однако
однозначно: однозначно
одолеть: одолеете
ожидать: ожидает
ознакомиться: ознакомиться ознакомьтесь
оказаться: оказаться
около: около
она: неё
опасный: опасными
описать: описать
описываться: описывается
опыт: опыта
оскандалиться: оскандалившиеся
особенно: особенно
особенный: особенный
особый: особого особой
осторожно: осторожно
ответный: ответный
отличаться: отличается
отставать: отставать
охотник: охотник
очень: очень
очередной: очередным
ошеломлять: ошеломляющее
ошибка: ошибка
ощущение: ощущения
парировать: парировать
партнёр: партнера
первоначально: первоначально
первоначальный: первоначальное
первый: первого первый
перечисленный: перечисленных
перечислить: перечислили
перо: пером
персонаж: персонажи
печальный: печальным
писать: пишите пишут
пк: пк
плакать: плакать
платформер: платформер
плеваться: плеваться
плейстейшен: плейстейшене
плойка: плойку
плохо: плохо
плохой: худших
плюс: плюс
победа: победа
победить: победить
побеждать: побеждает
побуждать: побуждает
поворот: повороты
повторить: повторить
повышение: повышения
погружать: погружает
подвести: подвели
подписаться: подпишитесь
подскочить: подскочит
поехать: поехали
позволять: позволяет позволяя
пока: пока
показать: покажут
поклонник: поклонников
поколение: поколения
покраснеть: покраснеть
полезный: полезных
полностью: полностью
полный: полон
получить: получите получить
помнить: помните
помочь: помогут поможет
понравиться: понравилось понравится
понять: поймёте
попасть: попали
попробовать: попробовать
попросить: попросите
популярность: популярности
поражение: поражение
посланник: посланник
последний: последнем последний
пост: посте
поставить: поставит
постараться: постарался
постоянно: постоянно
потерянный: потерянного
потерять: потерять
потрепать: потреплет
почему: почему
почувствовать: почувствуете
появляться: появляются
предел: предела
предлагать: предлагает
представить: представленными
представлять: представляет представляют
предшествовать: предшествовавшие
прелесть: прелести
преодоление: преодоление
препятствие: препятствием
пресса: прессы
приблизиться: приблизиться
привести: привело
привет: привет
привыкнуть: привыкли
признавать: признают
прийтись: придется пришлось
приключенческий: приключенческих
применение: применением
присвоение: присвоению
приступить: приступим
приятно: приятно
проанализировать: проанализировать
пробежаться: пробежаться
пробиваться: пробиваетесь
провальный: провальные
проверять: проверять
программа: программу
прогулка: прогулка прогулки
продажа: продаж
продать: продать
проект: проект проекты
проживать: проживает
производить: производит
произнести: произнесут
происходить: происходит
пройти: пройденных пройдя пройдёте пройти прошла прошли
проклинать: проклинали проклинать
пролог: пролога
проноситься: проносятся
пропустить: пропустите пропустить
просто: просто
простой: простые простых
противник: противника противниками
прохождение: прохождении прохождения
процесс: процесс
прочность: прочность
прямо: прямо
публикациина: публикациине
пульс: пульс
пункт: пунктом
пустота: пустоту
равно: равно
разбирательство: разбирательства
разблокировать: разблокировать
развлекательный: развлекательную
разгораться: разгорались
различный: различные различным
разногласие: разногласия
разочароваться: разочароваться
разочаровывать: разочаровывает
рассердить: рассердит
рассказать: расскажу рассказал
расширить: расширите
реальный: реальной реальным
режим: режим режиме
результат: результате
рейтинг: рейтинга
рейтинговый: рейтинговые
рекомендовать: рекомендуем рекомендую
рефлекс: рефлексов рефлексы
решительность: решительность
ритмический: ритмического
ролевый: ролевые ролевых
рост: росту
рпг: рпг
рублейдрузие: рублейдрузья
рубль: рублей
ругаться: ругаться
руководство: руководств
ручка: ручке
сам: самого самой самом
самый: самая самые самый самых
свет: свете
своевременно: своевременно
своеобразный: своеобразные
свой: свое своего свои своими свой
сдаться: сдадутся
сделать: сделать
себя: собой
сегодня: сегодня
секиро: секиро
серия: серии
сильно: сильно
сильный: сильнее
симулятор: симуляторы
система: системе
сказать: сказанное сказать
сказка: сказке
скандал: скандалами скандалы
скандальный: скандальных
скрытый: скрытый
слепо: слепо
сличить: сличить
сложность: сложности сложность
сложный: сложна сложная сложнее сложный сложных
смешной: смешного
смочь: сможете
смысловой: смысловой
снова: снова
сожаление: сожалению
сожрать: сожрут
сопровождаться: сопровождалась
состояние: состоянии
соулс: соулс
список: списка списке списки список
способ: способ
способность: способности
способствовать: способствовали
справиться: справитесь
спустя: спустя
сражаться: сражаясь
сражение: сражений
сразу: сразу
среди: среди
средневековье: средневековье
становиться: становится становиться
стараться: стараться
стать: станет стать
стиль: стиле стилем
стоить: стоит
стойка: стоек
столкнуться: столкнетесь
столько: столько
сторона: сторону
стоять: стоять
стоящий: стоящие
страна: стране
странный: странные
стрелять: стреляй
субъективный: субъективным
судебный: судебные
суть: сути
схватка: схваток
счастие: счастью
сын: сыну
также: также
такой: такие такого
телевизор: телевизора
темп: темпа
темувидеостатьироликиновостивидеоигрыдетямвсё: темувидеостатьироликиновостивидеоигрыдетямвсё
темувойтиглавнаяподпискинайти: темувойтиглавнаяподпискинайти
терпеливый: терпеливым
терпение: терпения
течение: течение
товарищ: товарищу
топ: топов топом
тот: тех той тому
точно: точно
точность: точности точность
трасса: трассах
требовать: требует требуют
трепать: трепать
трофей: трофей
труд: труда
трудность: трудности
трудный: трудна
туалетный: туалетной
тысяча: тысяч
тяжёлый: тяжела
тёмный: темных
уверенность: уверенностью
увлекательный: увлекателен увлекательный
удалить: удалите
удар: удар
удаться: удалось удастся
удваивать: удваивают
удивиться: удивились
ужасный: ужасные
уклоняться: уклоняться
умение: умения
упоминать: упоминали
уризть: уризена
уровень: уровне уровню уровня
усилие: усилия
успеть: успел
успех: успех
успокоить: успокоят
устранить: устранили
участвовать: участвовать
факт: факт
фанат: фанатами
фантастический: фантастические
фарш: фарш
физический: физическое
фильм: фильмы
финальный: финальному
формула: формулу
функция: функций
хамить: хамить
хозяин: хозяин
хороший: лучшим хорошим
хотеть: хотите хотят хочет
хотя: хотя
час: час часа
часто: часто
часть: часть
человек: человек
черенковолопатный: черенковолопатная
чертовски: чертовски
честно: честно
чистый: чистую
читать: читайте читали
чреватый: чревата
чувство: чувствах чувство
шаг: шаги
шанс: шанс
шедевр: шедевр
шутерыроссийский: шутерыроссийские
эдакий: эдакий
экран: экрану
элемент: элемент элементы
этап: этап
это: это
этот: эта
эффект: эффекты
являться: является
январяодный: январяодно
