азиатский: азиатских
алим: алиму
аниме: аниме
антон: антона
ассистый: ассисты
атака: атаки
балатро: балатро
башня: башня
безразличие: безразличия
бесплатный: бесплатным
бестия: бестией
блеф: блеф
близкий: близкий
бог: бога
большинство: большинстве
браться: берутся
бухарест: бухаресте
быстро: быстро
вакансия: вакансии
ватсон: ватсоном
весь: вся
вещь: вещи
взглянуть: взгляните
вид: виде
видеоигра: видеоигры
видимый: видимая
видно: видно
влезать: влезать
возможный: возможная
возникать: возникает
вправо: вправо
второй: вторая второй
выбрать: выбранном
выдумывать: выдумывал
выигрывать: выигрывал выигрывали
вылететь: вылетела
выпустить: выпустила
высокий: высокий высокому
вычисляться: вычисляются
гаремник: гаремников
герой: герое героев герои герой героя
главное: главного
год: год
грамотно: грамотно
группа: группе
давать: дает
давно: давно
даззло: даззла
даззлый: даззл
дать: данные
два: двух
действовать: действовали
делать: делать
день: день дня
десятка: десятке
джеки: джеки
джинва: джинву
джокер: джокер джокером
джонни: джонни
дзен: дзен
дзеневакансиидзен: дзеневакансиидзен
добывать: добывает
дойти: дошел
документ: документы
донатереть: донатер
драка: драк
драма: драм
драфтить: драфтил
друг: друг друга
дурачьё: дурачье
душа: душа душу
единица: единицы
единственный: единственный
естественно: естественно
жанр: жанре
ждать: ждали
забирать: забирайте
завершение: завершении
закончиться: закончился
заменять: заменял
заруинить: заруинить
зато: зато
здание: зданиям
значение: значением
игра: игра игре игры
играть: играл играть
играться: играется
игровой: игровой игровые
игрок: игрок игрока игрокам игроки игроков
игрыроссийский: игрыроссийские
игрыэкшн: игрыэкшн
изображенийкак: изображенийкак
изображенийлистать: изображенийлистайте
изображенийподпишиться: изображенийподпишитесь
индустрииигра: индустрииигры
интересуютсяследить: интересуютсяследить
история: историй
исход: исход
итог: итогам
итоговый: итоговый
каждый: каждому каждую
канал: канал
карта: карт
карточный: карточный
карьера: карьеры
керри: керри
кибер: кибер кибера
киберспортодиночный: киберспортодиночные
китаец: китайцы
количество: количество
коллаборация: коллаборации коллаборация
коллапс: коллапс
команда: команда
комедия: комедий
комикс: комиксов
компания: компания
комплектующиешутерымногопользовательский: комплектующиешутерымногопользовательские
компьютерный: компьютерная
конец: конец
консолинайти: консолинайти
контакт: контакты
король: королём
который: которую
коэффициент: коэффициент
край: край
ларл: ларл
ластхит: ластхитов
лететь: летит
лечение: лечение лечения
листать: листайте
лишь: лишь
максимально: максимально
манга: манга
манхв: манхва манхвы
маньхуа: маньхуа
матч: матча матчей матчи
медианный: медианная
месяц: месяца
мета: мете меты
мидёр: мидер
миллион: миллион
минрейтинг: минрейтинг
минута: минут минуту
минутакибер: минутакибер
минутакиберпанк: минутакиберпанк
минутыкибер: минутыкибер
мир: мир
млн: млн
многие: многие
мочь: можете
набирать: набирать
набрать: набрал
навязывать: навязывать
наглухо: наглухо
надеяться: надеемся
надоесть: надоел
назадподписатьсяновый: назадподписатьсяновая
найти: найти
направлять: направляет
невыносимый: невыносима
недосягаемый: недосягаем
немного: немного
неожиданно: неожиданно
неуязвимый: неуязвима
ниже: ниже
никто: никому
новый: нового новой новые
нотлый: нотл
обновление: обновлением
обратить: обратить
ограничение: ограничение
один: одной
одиночка: одиночку
ознакомиться: ознакомиться
они: ними
ооо: ооо
описание: описание
остальной: остальных
остаться: останется
отделять: отделяет
отличаться: отличаются
отлично: отлично
отличный: отличные
отрываться: отрываться
оцениваться: оцениваются
оценить: оценить
оценка: оценка оценки
очень: очень
параметр: параметру
патч: патче
первый: первую первые
плохо: плохо
победа: побед победу
побеждать: побеждали
повезти: повезло
поднятие: поднятие
подписчиковподписатьсярейтинг: подписчиковподписатьсярейтинг
позволять: позволяет позволяйте
позиция: позиций
показатель: показатели показатель
получиться: получилась
поляк: поляк
помощь: помощи
понять: понять
популярный: популярной
порой: порой
последний: последнем
постоянный: постоянных
потерять: потеряли
похожий: похожие похожих
починить: почините
предлагать: предлагаю
предмет: предметы
призовой: призовым
применять: применять
приход: приход
причём: причем
провести: провела провели
продолжительность: продолжительность
проиграть: проиграл проиграли
прокачка: прокачки
пропустить: пропустите пропустить
проработанность: проработанность
просесть: просели
противник: противника противникам
публикациина: публикациине
публикацииподписатьсярекомендовать: публикацииподписатьсярекомендуем
путь: пути
пятёрка: пятерка
разница: разница
ранг: рангам рангом рангу
расклеиться: расклеились
раскрыть: раскрыл
рассмотреть: рассмотрим
растянуться: растянулось
реворкнуль: реворкнули
регистрироваться: регистрируйтесь
результат: результат результате
рейтинг: рейтинг рейтингом
ролевый: ролевые
роль: роль
роуглайк: роуглайк
рука: рука
рукав: рукаве
рядом: рядом
самый: самые
саппорт: саппортов
сверкать: сверкали
свой: своем
связь: связь
сдать: сдали
сезон: сезон сезона
сильверхенд: сильверхендом
сильно: сильно
сильный: сильнейшая сильнейших
симулятор: симуляторы
следующий: следующие
слишком: слишком
сломать: сломана сломанного
смерть: смертей смерти смертью
смешной: смешные
смотреть: смотрите
совершать: совершать
совместный: совместное
сотрудничество: сотрудничество
спейс: спейса
список: списке
спортс: спортсе
способность: способности
справедливо: справедливо
сравнивать: сравниваем
среднее: среднем
средний: среднее средний средним средняя
ставка: ставка
стартовать: стартовало
статистика: статистика статистику
стома: стом
стратегия: стратегии
строение: строениям
студия: студия
суметь: сумела
считаться: считается
счёт: счетом
сыграть: сыграли
такой: таких такое
тащить: тащить
тело: тела телом
темойреклама: темойреклама
темувидеостатьироликиновостивидеоигрыдетямвсё: темувидеостатьироликиновостивидеоигрыдетямвсё
темувойтиглавнаяподпискинайти: темувойтиглавнаяподпискинайти
темуновинка: темуновинки
темыгеймингигровый: темыгеймингигровые
тиммейт: тиммейтов
титан: титан
тренер: тренера
третий: третий
труд: трудом
турнир: турнир турнира турнире
тыс: тыс
убийство: убийств убийства убийствах
увидеть: увидеть
ульт: ульта
ультимейт: ультимейт ультимейта
уровень: уровень уровня
урон: урон урона
успевать: успевал
успеть: успела
уходить: уходит
финал: финала
финалист: финалистам
фирма: фирма
фонд: фондом
формула: формула формулы
футболка: футболку
хвалить: хвалят
хватать: хватает
хороший: лучшая лучшие лучший хорошая хорошую
хотеться: хочется
худить: худи
часть: часть
человек: люди
четвёрка: четверка
число: чисел число
читать: читали
шанс: шансов
шутка: шутка
экранизация: экранизация
этот: этих
яркий: ярче
яторо: яторо
