аудитория: аудитории
баланс: баланс
божественность: божественность
божественный: божественная
вакансия: вакансии
вариативность: вариативность
ваш: ваш
ведро: ведро
ведьмак: ведьмак
вера: верой
вероятность: вероятность
взглянуть: взгляните
видеоигра: видеоигр
видюхий: видюха
включая: включая
влиять: влияя
вовсе: вовсе
вперёд: вперед
впечатлять: впечатляет
время: времени
выдающийся: выдающихся
выпустить: выпустила
выражение: выражений
выручка: выручка
высокий: высокая
геймдизайн: геймдизайна
геймплей: геймплей
герой: герой
главный: главный
год: год года году лет
годупереосмысление: годупереосмысления
графика: графика
далеко: далеко
данные: данным
дезориентировать: дезориентировать
декабрь: декабре
день: дня
десятка: десятки
дзен: дзен
дзеневакансиидзен: дзеневакансиидзен
дикий: дикая
документ: документы
доллар: долларов
домой: домой
дополнение: дополнение
достаточно: достаточно
доступ: доступе
другой: другие
ждать: ждут
желание: желания
злодейский: злодейскую
знаетво: знаетво
значительно: значительно
зона: зоны
зря: зря
игра: игра играх игры
игровой: игровой игровые
игрок: игроков
игрыроссийский: игрыроссийские
игрыэкшн: игрыэкшн
идея: идей
изометрический: изометрическая
индустрииигра: индустрииигры
индустрия: индустрии
инопланетянин: инопланетян
интерактивный: интерактивных
интересуютсяследить: интересуютсяследить
история: истории
канада: канада
канал: канал
карта: карта
картинка: картинки
киберспортодиночный: киберспортодиночные
классика: классика классике классики классику
количество: количество
комментарий: комментарий
комментироватьпока: комментироватьпока
комп: комп
комплектующиешутерымногопользовательский: комплектующиешутерымногопользовательские
компьютер: компьютером
конец: конец конца конце
консолинайти: консолинайти
контакт: контакты
концовка: концовки концовку концовок
кооперативный: кооперативный
копия: копий
который: которая которую которые который которых
культовый: культовой
максимально: максимально
маленький: меньше
мало: мало
менять: меняющие
место: местами
месяц: месяца месяцев
механик: механик
миллион: миллионов
минв: минв
минутмеч: минутмеч
млн: млн
многий: многих
мол: мол
мочь: мог
музейный: музейной
мы: нам
назадподписатьсябожественный: назадподписатьсябожественная
назадподписатьсясамый: назадподписатьсясамые
назадподписатьсяскрыть: назадподписатьсяскрытые
найти: найти
намного: намного
например: например
начало: начала
невероятный: невероятного
неделя: недели
нейтральный: нейтральное
неожиданный: неожиданным
неточный: неточная
нововведение: нововведений
новый: новая новые
обеспечить: обеспечили
обновить: обновил
обновление: обновления
обстановка: обстановке
ожидать: ожидаемые
около: около
оно: оно
особенно: особенно
особый: особого
остаться: останутся
отзыв: отзывы
отлично: отлично
относительно: относительно
отражаться: отражается
отставка: отставку
охота: охота
очень: очень
паркур: паркура
первый: первая первое
первымрекомендовать: первымрекомендуем
передумать: передумал
план: планах
подарить: подарила
подборка: подборке
подсчёт: подсчет
поздний: поздним
поиграть: поиграть
пойти: пошел
положительно: положительно
положительный: положительных
пользователь: пользователей
порадовать: порадуют
правда: правдой
предлагать: предлагали
предмет: предметы
преследование: преследования
пример: примером
проблема: проблемы
продаться: продалась
продвинуть: продвинутой
пройти: прошёл
прописать: прописанной
пропустить: пропустите пропустить
прослужить: прослужив
проходить: проходил
прошлое: прошлого
проявить: проявить
публикациина: публикациине
работать: работает
различный: различных
разный: разные
ранний: раннем раньше
реалия: реалиях
реальный: реальный
реиграбельность: реиграбельности
релиз: релизам
ремейк: ремейки
решить: решила
робот: роботов
ролевый: ролевая ролевые
россия: россия
самый: самые
свежий: свежие
свой: своего
сегодня: сегодня
симулятор: симуляторы
скайрим: скайрим
скакнуть: скакнула
скромный: скромным
собрать: собрали
современный: современной
составить: составила
состариться: состарятся
среди: среди
стать: стал станет
стратегия: стратегии
существовать: существуют
счастие: счастья
сша: сша
также: также
такой: такая таких
телекинез: телекинезом
тема: темой
темувидеостатьироликиновостивидеоигрыдетямвсё: темувидеостатьироликиновостивидеоигрыдетямвсё
темувойтиглавнаяподпискинайти: темувойтиглавнаяподпискинайти
темуновинка: темуновинки
темыгеймингигровый: темыгеймингигровые
тип: типу
тираж: тираж тиражом
тихонаписать: тихонапишите
точка: точки
точно: точно
традиция: традиции
три: трех
тыс: тыс
удобство: удобство
уйти: уйти
улучшать: улучшает
улучшить: улучшить
устаревший: устаревших
учитывать: учитывающее
февраль: февраля
финал: финалов
хватать: хватает хватало
хит: хитом
хоррор: хоррор
читать: читали
чёткий: четкие
шведский: шведская
эвакуация: эвакуации
эмоция: эмоций
это: это
