агрегатор: агрегатора
аксессуар: аксессуары
ассасин: ассасинов
афроамериканец: афроамериканца
батарея: батарей
безопасный: безопасным
боевик: боевика
боевой: боевой
будущее: будущее
быстрый: быстрой
важный: важная важного важную
вакансия: вакансии
вариация: вариации
вдохновиться: вдохновилось
век: века
вердикт: вердикт
весь: вся
взглянуть: взгляните
видео: видео
видеоигра: видеоигры
видеокарта: видеокарт видеокарте видеокарты
войти: войти
воображение: воображение
вперёд: вперёд
время: время
вряд: вряд
вспоминать: вспоминаем
встречаться: встречаются
всё: всё
вчера: вчера
вывалить: вывалив
выгодный: выгодные
выйти: выйдет вышли
вынести: вынесли
выпустить: выпустивших
выход: выхода
геймер: геймеров
гейминг: гейминг
геймплейный: геймплейные
герой: героев героями
гибкий: гибкой
главный: главная главными
год: год году лет
графика: графики графикой
графический: графические
давать: дают
дальнейший: дальнейшее
дата: дата дату
два: двумя двух
девушка: девушки
день: дня
дефицит: дефицит
дзен: дзен дзене
диск: диски
довольный: довольны
документ: документы
доллар: долларов
доступ: доступ
другой: другие другими других другое
думать: думал
душа: душе
ещё: ещё
её: её
завалиться: завалившийся
зависеть: зависеть
заказ: заказ
записать: записали
значимый: значимых
игра: игр игрой игру игры
игровой: игровой игровые
идея: идеи
издательство: издательства
изображение: изображений
индустрия: индустрии
инновация: инноваций
инсайдер: инсайдеры
интересный: интересных
интересоваться: интересуются
информация: информацию информация
исторический: исторических
история: историю история
источник: источник
канал: канал
канон: канона
картина: картина
киберспорт: киберспорт
китай: китай
комплектующие: комплектующие
компонент: компонентов
компьютер: компьютер
консоль: консоли
контакт: контакты
концепция: концепцией
концовка: концовку
копировать: копировал
который: которого которые который
красочный: красочным
критик: критиков
критика: критики
крупный: крупные крупных
купить: купить
кусаться: кусаются
лежать: лежат
литиевый: литиевых
лицо: лице
личность: личностей
луна: луне
любитель: любителям
любой: любые
магазин: магазины
майнер: майнеры
март: марта
материал: материале
менее: менее
мерка: меркам
месяц: месяца
механика: механики
мина: мин
минус: минусы
минута: минут
мир: мир миром
миядзак: миядзаки
млн: млн
мнение: мнении
многое: многое
многопользовательский: многопользовательские
мобильный: мобильные
модуль: модуль
назад: назад
наиболее: наиболее
найти: найти
наоэ: наоэ
настольный: настольной
неделя: неделю
недоступный: недоступна
немало: немало
нескоро: нескоро
ниндзя: ниндзя
новизна: новизну
новинка: новинки
новость: новостей новости
новый: нового новые
обзор: обзоров обзоры
обычно: обычно
ограничить: ограничит
одиночный: одиночные
одиссей: одиссей
однообразие: однообразие
оригинальность: оригинальность
основатель: основателем
основной: основной
остаться: остались
отзыв: отзывах
открыто: открыто
открытый: открытый открытым
относительно: относительно
отойти: отошли
отсутствие: отсутствие
официальный: официального
оценка: оценки
очень: очень
партия: партии
первый: первые
перенести: перенесет
переубедить: переубедит
планета: планете
погибнуть: погибнуть
поджанр: поджанр поджанра
подождать: подождать
подписаться: подписаться подпишитесь
подписка: подписки
подписчик: подписчиков
показатель: показатели
поколение: поколения
получить: получила получить
получиться: получилась
польза: пользу
попасть: попали
популярный: популярнейшего популярной популярный
поражать: поражают
последний: последних
почитать: почитать
править: правит
превзойти: превзошла
предложение: предложения
предполагаться: предполагалось
предсказуемый: предсказуемый
предыдущий: предыдущей
прежде: прежде
прибыть: прибудут
привнести: привнести
прийтись: придётся
приключение: приключения
прилавок: прилавках прилавков
принести: принесли принёс
приятный: приятной
провоцировать: провоцирующую
прогноз: прогнозы
продолжение: продолжение
проект: проектах проекту
производство: производства
прописать: прописанными
пропустить: пропустите пропустить
противник: противников
противоречивый: противоречивые
прошлый: прошлом
псевдоисторический: псевдоисторического
публикация: публикации
радиоастрономия: радиоастрономии
разворачиваться: разворачивается
раздутый: раздутый
разноплановый: разноплановой
разочаровывать: разочаровывающую
разработчик: разработчиков
рассказать: расскажем расскажет
ребёнок: детям
рейтинг: рейтингом
рекомендовать: рекомендуем рекомендуют
релиз: релиза релизов
рецензент: рецензенты
розница: розницу
ролевый: ролевые
ролик: ролики
российский: российские российских российскую
сайт: сайте
сам: самого самой
самурай: самурая
самый: самые
сборка: сборке
свежий: свежего
свой: свои
сегмент: сегментом
сегодня: сегодня
серия: серии
симулятор: симуляторы
система: системой
системный: системные
следить: следить
следующий: следующей следующий
слово: словами
сметать: сметали
собрать: собрали
собраться: собралось
создавать: создавая
создать: созданного
сойтись: сошлись
стабильность: стабильностью
становиться: становится
стараться: старались
стать: станет
статья: статьи
стелс: стелсом
страна: стран
стратегия: стратегии
структура: структуру
схожий: схожая
сша: сша
сюжет: сюжет
такой: такого
тамплиер: тамплиеров
тема: темой тему темы
технология: технологиям
требование: требования
тыс: тыс
тысяча: тысяч
удивить: удивили
указывать: указывая
уровень: уровне
успех: успеха
успешно: успешно
феодальный: феодальной феодальную
флагман: флагманом
формула: формуле
франшиза: франшизы
хидетака: хидетака хидетакой
хит: хита
хороший: хорошей
хт: хт
цена: цены
часть: частью
чип: чипы
читать: читали
шаг: шагом
шутеры: шутеры
экшен: экшен
экшн: экшн
эпоха: эпоху
явно: явно
япония: японии японию
ясукэ: ясукэ
