адаптация: адаптацией адаптации
аксессуарыновинка: аксессуарыновинки
аудитория: аудитория
больший: большими
большой: большой
бояться: боясь
будущее: будущего
буквально: буквально
бушевать: бушевала
быстро: быстро
быть: будут
вакансия: вакансии
ваш: ваши
вдвое: вдвое
взгляд: взглядом
взглянуть: взгляните
видеоигра: видеоигры
властелин: властелина
возвращение: возвращение
возможность: возможность
война: войн
воспоминание: воспоминания
вперёд: вперёд
впечатление: впечатлениях
вступительный: вступительных
второй: второй
выйти: выйдет вышла
выступать: выступает
галактика: галактика
гарри: гарри
главный: главных
год: года годом году
готовиться: готовится
готовый: готов готового
далее: д
два: двух
двигаться: движется
делать: делает
дело: дела дело
демон: демонами
день: днях
детство: детства
джадкинс: джадкинс
дзен: дзен
дзеневакансиидзен: дзеневакансиидзен
добрый: добрыми
документ: документы
дорогой: дорогие
доступный: доступен
доул: доул
душа: душой
желать: желаю
завалиться: завалившийся
заказать: заказала
замедление: замедления
заменять: заменять
занятый: занята
защищать: защищать
заявить: заявил
звёздный: звёздный
игра: игр игра игры
игровой: игровой
игрок: игроков
игрыгеймингнайти: игрыгеймингнайти
идти: идти
известно: известно
изображение: изображения
индустриимобильный: индустриимобильные
интересный: интересных
интересуютсяследить: интересуютсяследить
история: истории историю
источник: источник
канал: канал
картина: картина
киберспортэкшн: киберспортэкшн
китайский: китайское
кольцо: колец
комбат: комбат
комментированиярекомендовать: комментированиярекомендуем
комната: комнате
компания: компания
комплектующиестратегия: комплектующиестратегии
контакт: контакты
который: которого
крейсер: крейсер
кровавый: кровавых
крыло: крылом
курировать: курировал
лицензия: лицензии
луна: луне
любовь: любви
магия: магии
май: мая
маленький: маленьких
март: март
месяц: месяц месяца
мир: мира мире
млн: млн
многопользовательский: многопользовательские
модуль: модуль
мой: моё
момент: момент
морталый: мортал
мотив: мотивам
мрачный: мрачное
мур: мур
мёртвый: мёртв
нажать: нажмите
название: названием
называться: называлась
найти: найти
настолько: настолько
настоящий: настоящий
наступать: наступающим
начало: начала начале
начать: начали
недавний: недавнем
неделя: недели
новость: новостей
новый: нового новое новые новый новым
обижать: обижать
оборудование: оборудование
обязательно: обязательно
ограничить: ограничил
один: одним
одиссей: одиссей
одновременно: одновременно
ой: ой
оказаться: оказались
октябрь: октябре
оператор: операторы
оригинальный: оригинальные
отечественный: отечественным
отключеныавтор: отключеныавтор
открытие: открытия
очень: очень
ощущение: ощущениям
палач: палача
пандемия: пандемия
первый: первого первую первым первых
перезагрузить: перезагрузило
перезагрузка: перезагрузкой
перенести: перенесет
погибнуть: погибнуть
подготовка: подготовкой подготовку
подкаст: подкасте
подписаться: подпишитесь
подписчик: подписчикам
подписчиковподписатьсясериал: подписчиковподписатьсясериал
подрастать: подрастающего
пожелать: пожелать
позволить: позволит
поздравить: поздравить
пока: пока
поколение: поколение поколения
получиться: получилось
польза: пользу
попросить: попросили
популярный: популярной
поттер: поттеру
представить: представила
предыдущий: предыдущая
прежде: прежде
презентация: презентацию
премьера: премьере премьеры
привыкнуть: привыкнуть
прийти: прийти
приквел: приквел
приложить: приложивший
пример: примером
принести: принесут принёс
провести: провела
продлить: продлён
продолжать: продолжает
продуктивный: продуктивными
продюсер: продюсер
проект: проект проекта
производство: производство
пропустить: пропустите пропустить
проходить: проходил
процветание: процветание
прошлый: прошлом
публикациина: публикациине
публикацииподписатьсякомментарий: публикацииподписатьсякомментарии
пусть: пусть
путь: путь
пылиться: пылиться
работать: работаю
радиоастрономия: радиоастрономии
радость: радость
разработчик: разработчики
ранее: ранее
рассказывать: рассказываем
расти: расти
релиз: релизе релизом
рисковать: рисковать
рок: рока
ролевый: ролевые
ролик: роликов
рональд: рональд
российский: российские
россия: россии
рука: руку
руководство: руководство
рыцарь: рыцарей
рэйф: рэйф
сайт: сайте
связь: связи
сделать: сделал
сезон: сезон сезона сезонов
сервис: сервиса
сериал: сериал сериала сериалам
серия: серии серия
сеттинг: сеттинге
сильный: сильными
склад: складе
слабый: слабых
следующий: следующее
смочь: смог
снять: снять
совершать: совершать
современный: современные
сократиться: сократилась
состояние: состоянию
сохранять: сохранять
сразу: сразу
средневековьелегендарный: средневековьелегендарная
срок: сроки
стареть: стареть
стать: станет
стриминговый: стримингового
студия: студия
сценарий: сценарий сценария
сценарист: сценарист сценаристов
счастие: счастья
съёмка: съёмкам
тема: темой
темувидеостатьироликиновостивидеоигрыдетямвсё: темувидеостатьироликиновостивидеоигрыдетямвсё
темувойтиглавнаяподпискинайти: темувойтиглавнаяподпискинайти
темыодиночный: темыодиночные
тыс: тыс
уверенно: уверенно
уверить: уверена
удивить: удивить
успех: успехе
файтинг: файтингов
фанат: фанатов
фильм: фильм фильма
хит: хитов
холдинг: холдинга
хороший: хорошие
хотеть: хотел
хотя: хотя
читатель: читатели
читать: читали
шоу: шоу
шутерыроссийский: шутерыроссийские
эпоха: эпоху
это: это
этот: этому
