альтернативный: альтернативные
альтушка: альтушка
банковский: банковскими
боевик: боевике
боевой: боевой
бой: бои
брелок: брелока
будущее: будущего
вакансия: вакансии
ваш: ваш
весь: всем
взглянуть: взгляните
видео: видео
видеоигра: видеоигры
визуальный: визуальной
влиять: влияет
вместе: вместе
внимание: внимание
возможность: возможность возможностью
война: войн
войти: войти
вроде: вроде
всё: всё
вывеска: вывесок
высокий: высоких
выходец: выходец
выходить: выходящие
геймер: геймеры
гейминг: гейминг
главный: главная
год: лет
гость: гости
госуслуга: госуслуги
гром: гром
дело: деле
день: день дня
дзен: дзен дзене
динамичный: динамичный
документ: документы
достижение: достижения
доступ: доступ
доступный: доступны
едва: едва
ещё: ещё
жанр: жанр жанров
женский: женского
женщина: женщину
жизнь: жизни
заводить: заводить
завораживать: завораживающие
закрутить: закрученный
запись: запись
засветиться: засветились
звезда: звёзды
злой: злые
знать: знаете
игра: игр игра игре игрой игры
играть: играть
игровой: игровой
идеальный: идеальную
идти: идёт
избранный: избранный
изменить: изменили
именно: именно
иметься: имеются
индустрия: индустрии
интересоваться: интересуются
исследование: исследование
исследовать: исследовать
история: истории
итак: итак
казаться: казалось
кампания: кампания
камуфляж: камуфляжа
канал: канал
канон: канону
карта: картами
киберпанк: киберпанк киберпанка
коктейль: коктейля
коллаборация: коллаборация
комментарий: комментарии комментарий
комментировать: комментировать
контакт: контакты
корпоративный: корпоративных
корпорация: корпорации
косметический: косметическим
который: которые который
кроссовер: кроссовер кроссоверах
крутой: крутые
кто: кого кому
купить: купить
любой: любой
магазин: магазине
мало: мало
материал: материале
месяц: месяца месяцев
метроидвания: метроидвании
мина: мин
минута: минут минуты
мир: миры
млн: млн
молотов: молотова
мочь: могут
мрачный: мрачную
мужской: мужского
мужчина: мужчиной мужчину
мёмный: мемных
назад: назад
найти: найти
написать: напишите
напомнить: напомним
направление: направлений
насыщенный: насыщенные
научный: научные
начать: начнем
начаться: началась
некоторый: некоторые
необычный: необычного необычные
неожиданный: неожиданные
неоновый: неоновых
неравенство: неравенство
новелла: новеллой
новинка: новинки новинок
новость: новости новостями
новый: новые новый новых
ностальгический: ностальгический
нравиться: нравится
нынче: нынче
обратить: обратить
общество: общество
объединять: объединяющая
один: одной
ожидать: ожидал
оплата: оплаты
оружие: оружия
осенний: осенний
особенность: особенности
отличаться: отличается
отличие: отличия
отметить: отмечу
отсылка: отсылки
официальный: официальном
очевидный: очевидного
пара: пару
первый: первым
персонаж: персонажа
платформа: платформа
платформер: платформер
площадка: площадка
подписаться: подписаться подпишитесь
подписка: подписки
подписчик: подписчиков
пока: пока
получить: получить
популярный: популярном
портал: портале
последний: последней последних
посмотреть: посмотрим
почитать: почитать
появиться: появились появятся
практически: практически
предлагать: предлагают
предмет: предметам
привет: привет
приключенческий: приключенческого
природа: природу
приятный: приятное
продолжать: продолжает
прожить: прожить
пропуск: пропуск
пропустить: пропустите пропустить
просить: просил
просто: просто
процесс: процесс
птица: птицы
публикация: публикации
развиваться: развиваться
различный: различных
разный: разных
рай: раю
рассказать: рассказать
реальность: реальности
ребёнок: детям
регулярно: регулярно
режим: режим
рекомендовать: рекомендуем
ретрогеймер: ретрогеймер
ролевый: ролевой
ролик: ролики
российский: российскими
русский: русских
сайт: сайте
сам: самом
самый: самое самых
сегодня: сегодня
сезон: сезон
семь: семь
сказать: сказать
скин: скин
скуфа: скуфа
следить: следить
собрать: собрали
социальный: социальное
сочетать: сочетающий
сразу: сразу
становиться: становятся
стартовать: стартовал
стать: станет
статья: статье статьи
стиль: стиле
стоить: стоит
сюжет: сюжет
тайтлов: тайтлов
таки: таки
тактический: тактической
тема: темой тему темы
технология: технологии технологий
тихо: тихо
тот: тех
тыс: тыс
убежище: убежища
удивить: удивишь
уникальный: уникальный уникальным
упор: упором
учётный: учётную
фанат: фанатов
хороший: лучшие
хотеть: хотел
хотя: хотя
часть: части
человеческий: человеческую
читать: читали
шутеры: шутеры
шутеря: шутере
экшен: экшена
элемент: элементами
эстетика: эстетику
это: это
являться: является
