аба: абы
автор: авторы
александр: александр
анимация: анимации
антагонист: антагониста антагонистом
арена: арену
атака: атака
бассейн: бассейна
безумный: безумными
битва: битва битве битвой битву битвы
биться: бились
богатый: богатую
боец: бойца
бой: боем
большинство: большинство
борьба: борьбой
босс: босс босса боссах боссов боссом
босспоказать: босспоказать
брать: брать
бронь: брони
быстро: быстро
бэтмэн: бэтмэна
вакансия: вакансии
вариант: вариантами вариантов
ваш: вашему
вдалеке: вдалеке
верить: верили
вертолёт: вертолета вертолёт вертолёта
веселиться: веселились
весь: всей всем
взглянуть: взгляните
вид: виду
видеоиграхбыть: видеоиграхесть
вместо: вместо
внимание: внимание вниманию
вниманиепривет: вниманиепривет
возможно: возможно
возможность: возможность
возмутительно: возмутительно
война: войны
волна: волны
время: времени время времён
всадить: всадил
вскрыться: вскрылась
вспомнить: вспомним
вставать: вставать
встретиться: встретившись
всё: всё
второй: вторая вторую
вы: вами
выбор: выбор
выводить: выводили
выдерживать: выдерживает
вызвать: вызвали
вызывать: вызывала
выйти: вышел
выстрел: выстрел выстрелов
вытолкнуть: вытолкнули
выход: выходе
герой: герою героя
глава: глав
главное: главного
главный: главному главный главным главных
год: год
горо: горо
гранат: гранаты
гранди: гранди
громкий: громкими
давать: даём
давно: давно
далеко: далеко
данный: данную
двигаться: движутся
двинуть: двинет
действие: действие
действительно: действительно
делать: делаем
дело: деле дело
день: дня
держать: держала
джекнайфигра: джекнайфигры
джокер: джокер джокера
джокервозможный: джокервозможно
джон: джон
дзен: дзен
дзеневакансиидзен: дзеневакансиидзен
добиваний: добиванием
добраться: добраться
довольно: довольно
документ: документы
долго: долго
дом: дома
досаждать: досаждал
достаточно: достаточно
доходить: доходит
драться: деремся
друг: друг друга друзья
другой: другие другого другую
есть: ели
ещё: ещё
ещёвсема: ещёвсем
жаль: жаль
ждать: ждали
желать: желать
жестокий: жестоких
зад: зад
заклятый: заклятый
закончиться: закончились
заметка: заметки
замечательный: замечательной
запоминаться: запоминается запоминающегося
заскриптовать: заскриптованное
заслуживать: заслуживали
заставить: заставил
заставка: заставках заставке
защита: защиту
звать: звали
злодей: злодеев злодеем
золото: золото
игра: игр игра играх игре игру игры
игровой: игровой игровые
игрок: игрока игрокам игроки игроков
игрушка: игрушка
игрыроссийский: игрыроссийские
игрыэкшн: игрыэкшн
идея: идеи
известный: известного
иметь: имеет
иметься: имеется
имя: именем
индустрииигра: индустрииигры
инсайдер: инсайдера
интерес: интерес интересы
интересно: интересно
интересный: интересная интересного
интересуютсяследить: интересуютсяследить
исследуться: исследуются
история: истории история
итак: итак
итог: итоге итоги
июнь: июня
кадыр: кадыр
каждый: каждая каждой
какой: каких
канал: канал канале
капельку: капельку
карлик: карлик
квика: квик
киберспортодиночный: киберспортодиночные
кидать: кидает
кнопка: кнопки кнопок
комментарий: комментариях
комната: комнате
комп: комп
комплектующиешутерымногопользовательский: комплектующиешутерымногопользовательские
компьютер: компьютеры
конец: конца конце концов
конечный: конечном
конкретный: конкретного
консолинайти: консолинайти
контакт: контакты
контент: контент
который: которого которое которые которых
красивый: красивой
красить: красит
крипта: крипта крипты
критик: критиков
легко: легко
лениться: ленятся
лень: лень
либо: либо
линия: линиях
лишь: лишь
логика: логика
лучшепингвин: лучшепингвин
любить: любит
любовный: любовный
любовь: любовь
любой: любой
люциан: люциана люцианом
лёгкий: легкая легким
масштабный: масштабная
медленно: медленно
мелкий: мелкий
менять: меняя
мерзавец: мерзавца
месиловый: месилово
место: местами
месяц: месяц
минутзаметка: минутзаметки
минутигровый: минутигровой
мифология: мифологию
млн: млн
многие: многие
мочь: могли могло могут
мутант: мутантом
мы: нам
надрать: надрать
нажатие: нажатием
нажимать: нажимай нажимать
назадподписаться: назадподписаться
назадподписатьсяпочий: назадподписатьсяпочему
найти: найти
нанести: нанести
напоминать: напоминает
напряжение: напряжении
насладиться: насладиться
наслать: нашли
настоящий: настоящее
наш: нашу
неделя: недели
недовольство: недовольство
некоторый: некоторые
немного: немного
неоднозначный: неоднозначные
неплохо: неплохо
неприятный: неприятное
нервишки: нервишки
несколько: нескольких несколько
ниже: ниже
никакой: никакого никакой
ничто: ничем
новый: новые
нога: ногами
ноябрь: ноября
нужно: нужно
обитатель: обитателями
обмануть: обманули
обойма: обойму
обратить: обратить
обратный: обратном
общество: обществе
общий: общем
обычный: обычный
огромный: огромное огромные
один: одна одни одними одного
однако: однако
оказаться: оказался
оказываться: оказывается
окружить: окружили
он: нему
оружие: оружия
оскандалиться: оскандалившиеся
особенно: особенно
оставлять: оставляет оставляют
остаться: осталась
отвлекаться: отвлекаются
отема: отем
отличаться: отличаются
отношение: отношений
отомстить: отомстить
оценка: оценки
очень: очень
очередной: очередным
пакостить: пакостить
пасхалка: пасхалки
патрон: патронов патроны
первый: первой
пережить: пережить
переставлять: переставлять
перестрелка: перестрелках
персонаж: персонажа
пингвин: пингвин
писать: пишите
пить: пили
пк: пк
победа: победы
победить: победить
побеждать: побеждай
поворачиваться: поворачивается
повстречать: повстречать
повстречаться: повстречался
погибать: погибали
погибнуть: погибнет
поговорить: поговорим
подкачать: подкачал
подкидывать: подкидывает
подозрение: подозрение
подойти: подойдёт
подсветить: подсветить
поехать: поехали
позволять: позволял
поздний: позднее
познакомить: познакомить
пока: пока
пол: пол
полковник: полковник
полный: полную полон
получить: получившую получили
помереть: помереть
помнить: помните
помощник: помощниками
популярность: популярности
попутно: попутно
порядок: порядке
послевкусие: послевкусие
пост: посте
пострелять: пострелять
построить: построены
потребоваться: потребуется
потрепать: потрепать
потрясать: потрясающая
поэтому: поэтому
правда: правда
превосходительство: превосходительство
предпочитать: предпочитал
представлять: представляем
предыдущий: предыдущего
прибить: прибил
привести: привело
привет: привет
привычный: привычных
приземлить: приземленные
принцип: принципе
присвоение: присвоению
приступить: приступим
присутствовать: присутствует присутствуют
прихвостень: прихвостнями
провести: провести
продажа: продаж
проект: проекты
происходить: происходит
пропустить: пропустите пропустить
просто: просто
простой: простое простой простые
простошестеренка: простошестеренки
противник: противник
протяжение: протяжении
проходимец: проходимца
проходить: проходишь
прохождение: прохождение прохождения
процесс: процесс
прыгнуть: прыгнув
публикациина: публикациине
пустышкиигров: пустышкиигровой
пытаться: пытались
радиоактивный: радиоактивный
разбирательство: разбирательства
разгадать: разгадать
разгораться: разгорались
разногласие: разногласия
разнообразить: разнообразить
разочарование: разочарование разочарованием разочарований
разочаровать: разочаровали
разработчик: разработчики
раис: раис раисом
ракета: ракет ракетами
рассказать: рассказал
рассказывать: рассказывать
рассмотреть: рассмотрим
режим: режиме
рейтинг: рейтинга
рекомендовать: рекомендую
релиз: релизе
решение: решением
ролевый: ролевые
романтика: романтика
романтический: романтических
рост: росту
рука: рук
русский: русских
сайринназвать: сайринназвать
сам: сами само самого самом
самый: самый самым самых
сбрасывать: сбрасываем
сверху: сверху
свет: света
связь: связи
сгорбиться: сгорбившийся
сделать: сделана сделать
сегодня: сегодня
секрет: секретов
секция: секций
серия: серии
серьёзный: серьёзная серьёзный
сила: сил силу
сильно: сильно
сильный: сильным
симулятор: симуляторы
сказать: скажешь сказать
скандал: скандалами скандалы
скандальный: скандальных
скинуть: скинуть
скорый: поскорее
скрытый: скрытый
скучный: скучная скучный
слабак: слабак
слабакполковник: слабакполковник
слабый: слаб
следовать: следует
следующий: следующей
слишком: слишком
сложный: сложным
случиться: случилась
сначала: сначала
снять: сняв
создание: создание
солдат: солдат
соломон: соломон
сопровождаться: сопровождалась
составлять: составляет
список: список
спойлер: спойлеры
способствовать: способствовали
спрятать: спрятаны
сражаться: сражаемся
сражение: сражение сражением сражений
среди: среди
средство: средств
стараться: стараемся
стать: стал
стоить: стоило стоит
столовая: столовая
сторона: сторон сторону
стратегия: стратегии
стрелять: стреляем стреляет
строй: строя
судебный: судебные
судить: судя
сулейман: сулейман
супостат: супостат
суть: сути
сцена: сцена сценах
сценка: сценкой
сюжетный: сюжетных
тайм: тайм
тайна: тайну
также: также
такой: такая такие такого такое
темувидеостатьироликиновостивидеоигрыдетямвсё: темувидеостатьироликиновостивидеоигрыдетямвсё
темувойтиглавнаяподпискинайти: темувойтиглавнаяподпискинайти
темуновинка: темуновинки
темыгеймингигровый: темыгеймингигровые
требоваться: требовалось
трейлер: трейлеры
труд: труда
тусовка: тусовке
тянуть: тянет
убегать: убегаем
убивать: убивать убивают убивая
убить: убит
удар: удара
удивительный: удивительные
уик: уик
указанный: указанные
укрыться: укрыться
умирать: умирает
уныло: уныло
упасть: упасть
управление: управление
усложнить: усложнить
устранить: устранили
фарш: фарш
финал: финал финала финале
финальный: финальный финальным финальных
франшиза: франшиза
хватать: хватает
ходить: ходить
хорошенький: хорошенький
хорошенько: хорошенько
хороший: лучшего лучшими лучших хороших
хотеть: хотели хочешь
хотеться: хотелось хочется
хэдшота: хэдшот
часто: часто
часть: часть
чей: чьи
человек: человек
читать: читайте читали
чрезвычайно: чрезвычайно
шарахнуть: шарахнули
шкатулка: шкатулкой
щи: щам
эксклюзив: эксклюзив эксклюзивом
экшен: экшена
элемент: элемент
эмоция: эмоций
эпический: эпическое
это: это
этот: этих
являться: является
язык: язык
января: январяа
