агент: агента
айсберг: айсберга
аксессуар: аксессуары
антиутопический: антиутопическом
бодик: бодикам
бум: буму
важно: важно
вакансия: вакансии
вариация: вариации
ваш: ваш
вдохновиться: вдохновилось
вездесущий: вездесущая
версия: версия
верхушка: верхушка
взглянуть: взгляните
взять: возьмут
вид: видом
видео: видео
видеоигра: видеоигры
видеокамера: видеокамера
визуальный: визуальная
включая: включая
вовсе: вовсе
войти: войти
воспоминание: воспоминания
восточный: восточная
время: времена время
вряд: вряд
вспоминать: вспоминаем
всё: всё
входить: входят
выйти: выйдет
выпустить: выпустивших
выходить: выходило
геймер: геймерам
гейминг: гейминг
германия: германия
герой: героем
главный: главная главным
год: год года
горожанин: горожанин
движение: движения
демоверсия: демоверсию
день: дня
детектив: детектив
дзен: дзен дзене
документ: документы
доступно: доступно
другой: другие других
дть: демо
думать: думал
дух: дух
дэниел: дэниела дэниелом
дёргаться: дергающейся
ещё: ещё
жанр: жанра жанре
забытый: забытые
знакомство: знакомство
знакомый: знакомы
игра: играх игру игры
игровой: игровой игровые
игрок: игроки
идея: идеи
именитый: именитых
именно: именно
имитировать: имитирующей
индустрия: индустрии
институт: институте
инструмент: инструментов
интересоваться: интересуются
использоваться: использовалась
казаться: кажется
какой: какие
камера: камерой камеру
канал: канал
канон: канона
картинка: картинки
киберспорт: киберспорт
кинематографичный: кинематографичный
классический: классических
комментарий: комментарии комментарий
комментировать: комментировать
комплектующие: комплектующие
конкурент: конкурентов
консоль: консоли
контакт: контакты
концепция: концепцией
копировать: копировал копировали
корпорация: корпорация
который: которые
кошмар: кошмара
кто: кем
левиафан: левиафан
лицо: лица
лишь: лишь
любительский: любительской
любопытный: любопытный
макговерный: макговерна
март: марта
материал: материале
менее: менее
место: место
месяц: месяцев
механика: механики
мина: мин
минута: минут
мир: мире
миядзак: миядзаки
млн: млн
многопользовательский: многопользовательские
множество: множество
мобильный: мобильные
назад: назад
найти: найденными найти
написать: напишите
настоящий: настоящему
нательный: нательную
начало: начало
невероятный: невероятный
недооценить: недооцененные
немало: немало
нечто: нечто
новизна: новизну
новинка: новинки
новость: новости
новый: новое новые
обычный: обычная
одиночный: одиночные
однако: однако
опробовать: опробовать
оригинальность: оригинальность
основатель: основателем
открыто: открыто
отличие: отличие
отойти: отошли
ощущение: ощущение
первый: первого первый первым
переносить: переносят
пк: пк
плёнка: пленками
погружение: погружение погружения
поддержка: поддержкой
поджанр: поджанр поджанра
подозревать: подозреваемых
подписаться: подписаться подпишитесь
подписка: подписки
подписчик: подписчиков
позволять: позволяет
пока: пока
полицейский: полицейский
полный: полная
положить: положил
получить: получил
помнить: помните
помощь: помощью
популяризировать: популяризировали
популярный: популярнейшего популярный
потрясать: потрясающее
почитать: почитать
правда: правду
править: правит
прародитель: прародителями
предлагать: предлагает предлагали
представитель: представители
представить: представили
предстоять: предстоит
привнести: привнести
приключение: приключения
принести: принесли
проект: проектах проектов
пролог: пролог
пропустить: пропустите пропустить
просто: просто
психологический: психологический психологического
публикация: публикации
развивать: развивали
разворачиваться: разворачивающийся
разработчик: разработчиков
раскрыть: раскрыть
рассказать: расскажем
расследование: расследования
расследовать: расследующего
расцвет: расцвета
реализм: реализма
ребёнок: детям
рекомендовать: рекомендуем
ролевый: ролевые
ролик: ролики
роль: роль
российский: российские
саундтрек: саундтрек
свой: свои
серия: серии
симулятор: симуляторы
следить: следить
слепо: слепо
снятой: снятые
событие: события
совершенно: совершенно
создавать: создавая создают
создать: созданная созданного
сочетание: сочетание
становиться: становится
стараться: старались
старый: старых
стать: станет станете
статья: статьи
странный: странные
стратегия: стратегии
съёмка: съемки
тема: темой тему темы
тематический: тематические
тихо: тихо
топ: топ топы
трейлер: трейлер
триллер: триллер
тыс: тыс
удивить: удивили
ужастик: ужастики
уинстон: уинстона
ультрареалистичный: ультрареалистичный
усиливать: усиливают
успешно: успешно
характерный: характерной
хидетака: хидетака хидетакой
хит: хита
хороший: лучших
хоррор: хоррор хоррора хорроров
центр: центре
час: час
часть: часть
человек: человека
читать: читали
шутереть: шутер
шутеры: шутеры
экшен: экшен
экшн: экшн
эстетика: эстетикой
это: это
этот: этих
эффект: эффект
