активизироваться: активизируется
башня: башню
бег: бегу
бедствие: бедствия
бежать: бежать
бесплатно: бесплатно
благодаря: благодаря
бросить: бросить
быстрый: быстрее
быть: будут
важно: важно
вакансия: вакансии
великий: великий
весь: всем
взглянуть: взгляните
вздрогнуть: вздрогнут
внимание: внимание
впечатление: впечатлениями впечатлениях
врезаться: врезался
всё: всё
вход: входе
выглядеть: выглядит
выжить: выжившие
гб: гб
геймпад: геймпадом
геймпасс: геймпасс
герой: герои
глаз: глаза
говорить: говорил
горячий: горячим
готовиться: готовится
готовый: готовы
гулем: гулем
гулификация: гулификации гулификацию
гуля: гулей гули гуль гуля
делать: делать
делиться: делитесь
день: дня
дзен: дзен
дзеневакансиидзен: дзеневакансиидзен
дождаться: дождаться
документ: документы
должный: должны
достаться: досталась
достигнуть: достигший
единица: единиц
её: её
желать: желающий
забыть: забыла
завершение: завершения
завибрировать: завибрировал
загорелый: загорелая
заказ: заказы
запросто: запросто
заснуть: заснула
заставить: заставила
зато: зато
знать: знать знаю
зрелище: зрелище
игра: игре игрой игру игры
играть: играть
игровой: игровой игровые
игрыроссийский: игрыроссийские
игрыэкшн: игрыэкшн
именно: именно
индустрииигра: индустрииигры
интересный: интересные
интересуютсяследить: интересуютсяследить
информация: информации
история: историю
истребитель: истребитель
йога: йогой
к: ко
каждый: каждую
какуль: какуля
канал: канал
категория: категорию
качать: качать
квест: квест
киберспортодиночный: киберспортодиночные
команда: команда
компания: компанию
комплектующиешутерымногопользовательский: комплектующиешутерымногопользовательские
консолинайти: консолинайти
контакт: контакты
который: который
кстати: кстати
легендарный: легендарных
лена: лена
ломаться: ломается
любимый: любимой
любить: любят
любой: любой
макияж: макияж
меткость: меткостью
мечта: мечты
миноглавлениечтый: миноглавлениечто
минутален: минуталена
минутылить: минутылена
млн: млн
мочь: могу
найти: найти
напролёт: напролет
напрягать: напрягая
настроить: настроить
натурально: натурально
некоторый: некоторые
неудивительный: неудивительно
новость: новостями
новый: новые
ночь: ночи ночь
нпс: нпс
обзор: обзор
обнова: обновы
обновление: обновления
образ: образе
обратить: обратить
общение: общением
община: общиной
одичание: одичания
однажды: однажды
одноимённый: одноименный
окончательно: окончательно
октябрь: октября
оптимальный: оптимальном
организм: организм
оружие: оружие
основа: основе
особенно: особенно
особый: особая
отдельно: отдельно
отменить: отменить
оторваться: оторваться
ощутить: ощутить
падать: падает
пакет: пакет
пара: пару
перковы: перков
персонажка: персонажка
персональный: персональные
пк: пк
повлиять: повлиял
повторно: повторно
поговорить: поговорим
погружение: погружения
поддерживать: поддерживать
подписаться: подпишитесь
подписка: подписке
подписчиковподписатьсясвершиться: подписчиковподписатьсясвершилось
позаниматься: позаниматься
поздний: позже
познакомиться: познакомиться
помочь: помочь
попасть: попала
поспать: поспать
потрепать: потрепанной потрепанную
правда: правда
представитель: представителями
прелесть: прелесть
препарат: препаратов
прийтись: придется пришлось
примерить: примерить
приятно: приятно
провести: провести
производительность: производительности
пройти: пройдя прошла
пропустить: пропустите пропустить
проснуться: проснулась
прохождение: прохождения
птс: птс
публикациина: публикациине
пусть: пусть
пёрка: перки
радио: радио
разговаривать: разговаривают
разобраться: разберусь
рассказать: расскажу
расслабиться: расслабиться
решительный: решительный
родный: родном
ролевый: ролевые
рука: руках
сбегать: сбегать
свершиться: свершилось
светящийся: светящийся
свой: своей своих
сегодня: сегодня
сериал: сериал
сериальный: сериальный
сигнал: сигнал
сильно: сильно
симулятор: симуляторы
сказать: скажу
скептик: скептики
славиться: славились
след: следам
следить: следите
смочь: сможет
снижаться: снижается
сон: сон
состояние: состоянии
специальный: специальный
спокойный: спокойной
способный: способен
справочник: справочник
сразу: сразу
стать: стать
стратегия: стратегии
субтитр: субтитров
считать: считай
сюжетный: сюжетную
татушка: татушки
темувидеостатьироликиновостивидеоигрыдетямвсё: темувидеостатьироликиновостивидеоигрыдетямвсё
темувойтиглавнаяподпискинайти: темувойтиглавнаяподпискинайти
темуновинка: темуновинки
темыгеймингигровый: темыгеймингигровые
техработа: техработ
точно: точно
точность: точность
тыс: тыс
убежище: убежища
уважаемый: уважаемые
увлечься: увлеклась
удивительно: удивительно
ужасный: ужасный
употреблять: употреблять
уровень: уровень уровня
утром: утром
учитывать: учитывая
ущерб: ущерба
финал: финале
фракция: фракции
халява: халяву
ход: ходу
хотеться: хочется
час: час часов
человек: человеку
чтение: чтением
шаг: шаг
шкала: шкала
шкура: шкуре шкуру
это: это
язык: языке
языковый: языковый
