автор: авторы
аксессуарымобильный: аксессуарымобильные
актёр: актеры
английский: английский
андеграундный: андеграундных
анонсировать: анонсирующий
аспект: аспекты
бакалавр: бакалавра
бесплатно: бесплатно
бесплатный: бесплатная бесплатный
бесполезный: бесполезный
боевой: боевую
больной: больных
быть: будут
вакансия: вакансии
версия: версии версия
весна: весной
весь: весь
взглянуть: взгляните
включать: включают
вместо: вместо
внутренний: внутренняя
внушительный: внушительным
возвращаться: возвращается
возникнуть: возникли
время: времени время
выйти: выйдет вышел вышла
выпустить: выпустив выпустили выпустят
выход: выхода выходе
гб: гб
геймер: геймеров геймеры
геймплей: геймплей
год: года году лет
городкевыйти: городкевышла
далёкий: далёком
даниил: даниила
данковский: данковского
дата: дату
движок: движке
делаться: делается
демоверсия: демоверсия
демонстрировать: демонстрируют
день: дня
дзен: дзен
дзеневакансиидзен: дзеневакансиидзен
диагностика: диагностики
документ: документы
долгожданный: долгожданный
друг: друзей
другой: другие
жанр: жанра
задача: задач
затронуть: затронули
игра: игра игре игру игры
игровой: игровой игровые игровых
игрок: игроки
игрыигровой: игрыигровые
игрыэкшн: игрыэкшн
империя: империя
интерактивный: интерактивного
интересуютсяследить: интересуютсяследить
исправление: исправления
исследование: исследования
исследовать: исследовать
история: история
итог: итоге
кадр: кадры
какой: какие
кампания: кампании
канал: канал
киберспортшутерыроссийский: киберспортшутерыроссийские
ключевой: ключевой ключевые
команда: команда
компания: компания
комплектующиестратегия: комплектующиестратегии
контакт: контакты
который: которого которые которых
кража: кражи
критика: критикой
кроме: кроме
культовый: культовой
лаборатория: лабораторию
лишиться: лишились
локализация: локализацию
май: мая
манер: манер
место: места
месяц: месяц месяца месяцев
механик: механик
минзагадка: минзагадки
мир: мир
млн: млн
многопользовательский: многопользовательские
множество: множество
момент: момента
награда: наград
назадподписаться: назадподписаться
назадподписатьсяистория: назадподписатьсяистория
название: названием
назвать: назвала
найти: найти
начало: начале
негодование: негодования
непростой: непростой
новинка: новинки новинку
новый: новой новые новых
номинация: номинации
обновить: обновленной
обрести: обрел
объявить: объявили
один: одним одну
однако: однако
ожидать: ожидало
озвучивать: озвучивать
октябрь: октября
оригинал: оригинал
оригинальный: оригинальной
отметить: отметили
ошибка: ошибок
пациент: пациентов
перевести: переведут
персонаж: персонажей
пк: пк
платформинг: платформинга
победа: победа
поддержать: поддержавшие
подписчиковподписатьсявыйти: подписчиковподписатьсявышла
подробность: подробности
показ: показа
показать: показала показали
покинуть: покинувшего
получить: получить
пользователь: пользователей пользователи
помощь: помощью
популярность: популярность
поступить: поступит
посёлок: посёлке
потерять: потеряли
почему: почему
право: прав
предзаказ: предзаказов
представитель: представителей
представить: представили
презентация: презентации
приземлить: приземленные
принимать: принимать
проблема: проблемы
пробный: пробная
продажа: продажу
произведение: произведение
пройти: прошли прошло
прологподпишиться: прологподпишитесь
пропустить: пропустите пропустить
прославиться: прославилась
прохождение: прохождении
прошлый: прошлом прошлых
публикациина: публикациине
публикацииподписатьсярекламарекомендовать: публикацииподписатьсярекламарекомендуем
путешествие: путешествий
путь: путь
ради: ради
разгадывать: разгадывать
разнообразие: разнообразие
разработчик: разработчики
раскритиковать: раскритиковали
раскрыть: раскрыли
рассматривать: рассматривает
релиз: релиз релиза
релизановый: релизановая
ремейк: ремейк ремейка
решение: решения
ролевый: ролевая ролевые
ролик: ролики
русский: русский
сбор: сбору
свободный: свободного
свой: своё
серия: серии
симулятор: симуляторы
система: системе систему
скрытый: скрытые
смочь: смогут
создавать: создают
список: списком
сражение: сражения
средне: средне
средство: средств
стать: стал
степной: степном
столичный: столичную
столкнуться: столкнулся
студия: студии студию студия
судьбоносный: судьбоносные
сырой: сырой
сюжет: сюжет
таинственный: таинственной
тайна: тайны
также: также
талантливый: талантливых
тема: теме темой
темувидеостатьироликиновостивидеоигрыдетямвсё: темувидеостатьироликиновостивидеоигрыдетямвсё
темувойтиглавнаяподпискинайти: темувойтиглавнаяподпискинайти
темуновинка: темуновинки
темыодиночный: темыодиночные
тестирование: тестирования
тот: те
точный: точную
требование: требования
трейлер: трейлер
три: трёх
тусовка: тусовок
тыс: тыс
убить: убил
узнать: узнать
упор: упор
успех: успех успеха
хороший: лучшая лучших
хоррор: хоррора
церемония: церемонии
часть: часть
число: числе
читать: читали
шутер: шутера шутеров
эксклюзив: эксклюзивом
элемент: элемент
эпидемия: эпидемии эпидемия
эстонский: эстонская
это: это
язык: языки
