автор: автор авторы
автошутереть: автошутер
аж: аж
аксессуарымобильный: аксессуарымобильные
активный: активные активным
атака: атаками
баг: баги
баланс: баланс
бандит: бандитами бандитов
бар: бар
безумие: безумия
беспощадный: беспощадных
бессонный: бессонных
бесчисленный: бесчисленным
битва: битве
благодаря: благодаря
богатый: богатой
боевой: боевое боевые
босс: боссом боссы
будущий: будущих
быстро: быстро
быстрый: быстрые
быть: будете
важный: важную
вакансия: вакансии
вдохновляться: вдохновлялись
взаимодействовать: взаимодействовать
взглянуть: взгляните
возможность: возможности возможностями
вознесение: вознесение
волна: волнами волны
вопрос: вопрос
враг: врагами врагов
всё: всё
выбор: выбор
выживание: выживание
выжить: выжить
выйти: выйдут вышел вышла
выкатить: выкатили
выполнять: выполнять
выпустить: выпустила
выход: выхода
геймер: геймерам геймеры
герой: герой
главный: главный
глюк: глюков
год: год года годах году
годувсема: годувсем
графический: графическими
давать: давайте
дата: дата
движок: движка
делать: делая
дзен: дзен
дзеневакансиидзен: дзеневакансиидзен
динамичный: динамичный
документ: документы
достижение: достижения
доступ: доступе
доступный: доступна
дух: духе
её: её
жанр: жанр жанре
забег: забегом
задание: задания
заметно: заметно
захватить: захвачены
захватывать: захватывающие захватывающим
земля: земли
зима: зимы
знать: знаете
игра: игр игра игры
играбельновот: играбельновот
играть: играть
игрня: игрне
игроблогер: игроблогер
игровой: игрового игровой игровом игровые
игрыигровой: игрыигровые
игрыэкшн: игрыэкшн
идеальный: идеальной
идти: идет
индустрия: индустрии
инновация: инновации
интересуютсяследить: интересуютсяследить
информация: информацию
искусствосмодать: искусствосможете
исправить: исправлен
испытание: испытаний
иссякать: иссякаемая
истина: истины
история: истории
каждый: каждый каждым
казаться: кажется
канал: канал
карта: карты
киберспортшутерыроссийский: киберспортшутерыроссийские
клон: клонов
книга: книг
количество: количеством
комментарий: комментариях
комплектующиестратегия: комплектующиестратегии
контакт: контакты
который: которая которого которой которые который которых
кошелёк: кошелька
крутой: крутых
лекарство: лекарство
лёгкость: лёгкостью
март: марта марте
материал: материале
месяц: месяц месяца месяцев
механик: механиками
миноглавлениеосвыть: миноглавлениеосвойте
минута: минут
минутыблог: минутыблог
минутыигров: минутыигровой
мир: мир мире
млн: млн
многий: многих
многопользовательский: многопользовательские
многочисленный: многочисленные
могущественный: могущественным
мод: модов
мододел: мододелы
мододело: мододелами
монстр: монстрами монстров
мотив: мотивам
мощный: мощного
назадподписатьсятоп: назадподписатьсятоп
назадподписатьсяфевралить: назадподписатьсяфевраль
найти: найти
народ: народ
начать: начал
небольшой: небольшие
необходимый: необходимых
несколько: несколько
новинка: новинки новинку
новогодний: новогодних
новый: новые новый новых
ночь: ночей
нравиться: нравятся
обзор: обзор
обсуждать: обсуждаем
обычный: обычном
одолеть: одолеть
ожидать: ожидаемые ожидаемый ожидаемых ожидает ожидают
он: нём
опасный: опасное
оперативность: оперативностью
основа: основе
особенно: особенно
особенность: особенности особенностях
открыться: откроется
отойти: отойти
отправиться: отправиться
отыскать: отыскать
очень: очень
пассивный: пассивные
переживать: переживайте
персонаж: персонажа
пиксельный: пиксельный
пк: пк
план: плане
платформа: платформа платформой платформы
плач: плачу
подкинуть: подкинул
подписаться: подпишитесь
пользователь: пользователям
помимо: помимо
помощь: помощью
понравиться: понравился
пополнение: пополнения
поражать: поражает
поражение: поражении
последний: последний
потрясать: потрясающими
предстоять: предстоит
привет: привет
приключение: приключения
приносить: приносит
приобрести: приобрести
приобретать: приобретать
приходить: приходить
приём: приёмы
пробыть: пробудет
проводить: проводить
продвигаться: продвигаться
продолжительность: продолжительностью
проект: проект
производительность: производительность
пропустить: пропустите пропустить
просто: просто
противник: противников
прохождение: прохождения прохождениями
процесс: процесс процессе
публикациина: публикациине
путешествие: путешествие
путь: пути
развитие: развитие
разнообразный: разнообразные
разработчик: разработчик
ранний: раннем
расправляться: расправляться
рассмотреть: рассмотрим
реалистичный: реалистичным реалистичных
ребята: ребята
релиз: релизов релизы
речь: речь
решать: решает
ролевый: ролевого ролевой ролевые
российский: российской
рпг: рпг
рубль: рублей
рушиться: рушится
самый: самый самым самых
сборка: сборки
свой: своего своим
сделать: сделан
себя: собой
сегодня: сегодня
сессия: сессии
сиквел: сиквел
сильный: сильнее
скрытый: скрытые
слишком: слишком
сложный: сложные сложным
смотреть: смотрю
смочь: смогут
снаряжение: снаряжение снаряжения
собрать: собрали
собственный: собственного
создание: создании создания
создать: созданные
составлять: составляет
сочетать: сочетают
сражаться: сражаться
сражение: сражение сражения
сразу: сразу
стамин: стамина
становиться: становится
стать: станет стать
стиль: стиле
стоимость: стоимость
столкнуться: столкнётся
студия: студия
суть: сути
сюжет: сюжету
сюрприз: сюрпризов
также: также
творить: творишь
тема: теме
темувидеостатьироликиновостивидеоигрыдетямвсё: темувидеостатьироликиновостивидеоигрыдетямвсё
темувойтиглавнаяподпискинайти: темувойтиглавнаяподпискинайти
темугеймингновинка: темугеймингновинки
темыодиночный: темыодиночные
технологический: технологические
трудолюбие: трудолюбием
ты: тобой
тыс: тыс
убивать: убивая
убрать: убрали
увлекательный: увлекательные
удаться: удастся
удивительный: удивительные удивительный
улучшить: улучшили улучшить
умение: умений
уникальный: уникальными
упадок: упадок
упор: упор
уровень: уровне
условный: условные
успеть: успели
устанавливать: устанавливать
февраль: февраль февраля
финальный: финальным
функция: функция
хороший: лучших
час: часов
читать: читали
экшен: экшен экшена экшены
эльфийка: эльфийка
это: это
этот: этому
