абсурдный: абсурдным
авось: авось
автор: авторов
аксессуар: аксессуары
анимация: анимацией
аниме: аниме
антоха: антоха
атака: атаки
атаковать: атаковать
атмосфера: атмосфера атмосферой
беда: беде
безымянный: безымянного
берсерко: берсерком
битва: битвы
бить: бьют
биться: биться
бла: бла
близлежащий: близлежащие
блог: блог
блёклый: блеклыми
бой: бои бой
больно: больно
большой: большое
бороться: бороться
борьба: борьбу
босс: босса боссами боссы
боёвка: боёвка боёвке
брать: берём
былой: былое
быстро: быстро
быть: будем буду
важный: важна
вакансия: вакансии
вариация: вариации
ваш: ваше
вдохновиться: вдохновилось
ведущий: ведущим
великий: великой
вернуться: вернёмся
вести: ведут
весь: всем
весёлый: веселые
вещица: вещиц
взаимодействие: взаимодействие
взглянуть: взгляните
взять: взяли
вид: видами виде видов виды
видео: видео
видеоигра: видеоигр видеоиграх видеоигры
видеть: видела видеть
видимо: видимо
визуал: визуал
вк: вк
властелин: властелину
вместо: вместо
вначале: вначале
внимание: внимание
вновь: вновь
водопад: водопадом
возвращаться: возвращается
возможность: возможность
войти: войти
вокруг: вокруг
вообще: вообще
вопрос: вопрос
восстановить: восстановить
восстать: восстала
восторг: восторг
впечатление: впечатлениями
враг: врагами врагов
время: времена временем время
вряд: вряд
вселенная: вселенной
вспоминать: вспоминаем
вспомнить: вспомнить
вступить: вступил
всякий: всякие
всё: всё
второстепенный: второстепенного
вчера: вчера
вы: вами
выбрать: выбранным
вывод: вывод
выгорание: выгоранием
выживать: выживаем
выйти: выйдет
выносливость: выносливости
выполнить: выполнить
выпустить: выпустивших выпустить
выступать: выступает
выход: выхода
выходить: выходит
гейминг: гейминг
генерал: генерал
героиня: героинь
герой: героев герои герой героя героям
главное: главное
главный: главная главные главный главных
глаз: глаз глаза
гоблин: гоблинами
говориться: говорится
год: год года году
господин: господа
готика: готики
готовить: готовят
готовиться: готовьтесь
графика: графика
грешный: грешна
группа: группа группу
дабы: дабы
давать: давайте дают
давненько: давненько
давно: давно
далее: д далее
далёкий: дальше далёкие
дама: дамы
данный: данном
дата: дата
дать: данной
два: двумя двух
девчонка: девчонки
дейли: дейли
делать: делаем делала делать
дело: дел
демка: демка
демке: демке
демки: демки
демку: демку
демоверсия: демоверсии демоверсию
день: день днях
дерзко: дерзко
дзен: дзен дзене
диалог: диалоги
дико: дико
динамично: динамично
дистанция: дистанции
дичь: дичь
днайва: днайв
дно: дно
добиться: добиться
добрый: добрый
дождаться: дождаться
документ: документы
долгий: долгие
долгожданный: долгожданный
дополнить: дополнят
дороговатый: дороговато
дорогой: дорогие
доставать: доставала
достаточно: достаточно
достойный: достойную
доступный: доступен
дракон: драконом
друг: друг друга друзья
другой: другие
дрю: дрю
дть: демо
думать: думаешь думал думала думаю
душа: души
ещё: ещё
её: её
жажда: жаждой
жанр: жанр жанре
ждать: ждать ждут
женский: женских
жестоко: жестоко
жизнь: жизнь
жирненький: жирненькими
житель: жителями
жёстко: жёстко
забавный: забавная
заботиться: заботимся
забросить: забросила
забывать: забываем
завтра: завтра
задушниться: задушнилась
заметить: заметила
заметно: заметно
запоминаться: запоминаются
засесть: засесть
заснеженный: заснеженные
застревать: застревая
затем: затем
затестил: затестила
захотеть: захотел
здорово: здорово
земля: земли
зло: зла
знакомиться: знакомимся
знать: знаем знаю
золото: золото
игра: игр игра играх игре игру игры
играть: играем играла играть играю
игровой: игровой игровые игровым
игроед: игроед
игрок: игроки
игруль: игрули
идея: идеи
избежать: избежать
известный: известна известный
измена: измене
изолента: изоленты
изредка: изредка
изучать: изучать
именно: именно
иметься: имеется
иначе: иначе
индустрия: индустрии
иной: иной
инструмент: инструменты
интересненький: интересненького
интересный: интересная интересное интересный интересных
интересоваться: интересуются
информация: информации
испытывать: испытывала
исследовать: исследуем
история: истории
исход: исход
итог: итоге
каждый: каждого каждому каждый
казаться: кажется
какой: каким
канал: канал
канон: канона
карпишина: карпишин
катастрофически: катастрофически
каяться: каюсь
квест: квестов квесты
киберспорт: киберспорт
кислород: кислорода
кислородный: кислородных
класс: классом
клинок: клинка
колония: колонии
кольцо: колец
команда: команде
комментарий: комментарий
комплектующие: комплектующие
компонент: компоненты
конец: конец конца
конечный: конечном
консоль: консоли
контакт: контакты
конфэткать: конфэтку
концепция: концепцией
копировать: копировал
кореец: корейцы
короткий: короткая короткие
корпорация: корпорацией
космолёт: космолёт
космос: космосе
который: которая которого которой котором которые который которым
краска: краски
крафтим: крафтим
кроваво: кроваво
кротокрыса: кротокрысы
круто: круто
крутой: крутой крутые
культовый: культовая культовой
курица: курицы
л: л
лайк: лайк
легенда: легенда
лежать: лежит
либо: либо
лишний: лишним
локализация: локализация
локация: локации локациях
ломаться: ломались
лук: лук
любимый: любимый
любопытный: любопытном
мало: мало
март: марта
материал: материале
медленно: медленно
менее: менее
местечко: местечек
место: места месте
месть: мести
месяц: месяца
механика: механики
мимо: мимо
мина: мин
минута: минут
мир: мир мире
миша: миша
миядзак: миядзаки
млн: млн
многие: многие
многий: многим
многопользовательский: многопользовательские
множество: множество
мобильный: мобильные
мой: мои
момент: момент
монстр: монстров
морально: морально
мочь: могу можем можешь
мощно: мощно
мощный: мощная мощные
мужик: мужик мужика
музыка: музыку
мы: нам
набирать: набираем
наверное: наверное
наворотить: наворотим
навык: навыками навыки
навёрстывать: навёрстывать
награда: награду награды
надеяться: надеюсь
назад: назад
название: названии
наизусть: наизусть
найти: найти
накапливать: накапливаешь
накопиться: накопившейся
написать: напишете
напоить: напоить
народ: народ
насладиться: насладиться
научный: научной
находиться: находятся
начало: начале
наш: наше нашего нашей нашем
недавно: недавно
некий: некая
некоторый: некоторые
немало: немало
немного: немного
ненависть: ненавистью
необходимый: необходимые
необычный: необычная
непривычно: непривычно
непростой: непростыми
несколько: несколько
неспешный: неспешных
неудача: неудачи
никак: никак
никто: никто
никуда: никуда
нираса: нираса
нирасу: нирасу
новизна: новизну
новинка: новинки
новость: новости
новый: новая новой новом новые новым новых
норма: норма
ночлег: ночлег
нпс: нпс
нужно: нужно
нужный: нужен
нырнуть: нырнуть
нюанс: нюанс
обвинить: обвинили
обещать: обещает обещают
обзор: обзор
обида: обидой
обидеться: обиделся
обитатель: обитателях
облегчать: облегчающие
обожать: обожаю
обращение: обращению
обучать: обучает
общий: общем
обыскать: обыскала
оглавление: оглавление
оглушать: оглушая
один: одна одним одному
одинаковый: одинаковые
одиночный: одиночные
однако: однако
озвучка: озвучку
ознакомиться: ознакомиться
олд: олды
они: ними
описание: описанием
оптимизация: оптимизацией
оригинальность: оригинальность
оружие: оружием оружия
освободить: освободила
осмотреть: осмотреть
основатель: основателем
особенно: особенно
особый: особой
оставить: оставила
ответить: ответила
отдельный: отдельная отдельный
открыто: открыто
открытый: открытом
отлетать: отлетать
отличаться: отличаются
отличительный: отличительная
отметить: отмечу
отовсюду: отовсюду
отойти: отошли
отправлять: отправляют
отсылка: отсылку
отыскать: отыскать
ох: ох
охотиться: охотится
очень: очень
ощущаться: ощущалось
падальщик: падальщиками
память: память
парень: парни
парирование: парирования
первый: первого первых
перекат: перекаты
перестать: перестала
персонаж: персонажа персонажами
песенка: песенкой
пещера: пещерах
пк: пк
планет: планетам
плотненький: плотненько
плохо: плохо
победа: победа
победить: победил
погнать: погнали
поговорить: поговорим
подвести: подведут
поделиться: поделюсь
поджанр: поджанр поджанра
поджидать: поджидали
подкосить: подкосили
поднимать: поднимать
поднять: поднять
подписаться: подписаться подпишетесь подпишитесь
подписка: подписки
подписчик: подписчиков
подставить: подставили
подход: подход
позалипать: позалипаю
поиграть: поиграть
поиск: поисках
пока: пока
показать: показали показать
поклонник: поклонникам
полноценно: полноценно
полусмерть: полусмерти
получиться: получилось получится
польза: пользы
полюбиться: полюбившейся
помнить: помнят
помощь: помощи
понемножечку: понемножечку
понять: поняла
попадаться: попадается попадались
попробовать: попробовать
популярный: популярнейшего популярный
попытаться: попытаемся попытаться
пора: пор пора
поработать: поработать
порадовать: порадовало
порой: порой
портрет: портретом
посетить: посетим
последний: последнее
посмотреть: посмотрела посмотрим
поставить: поставите
постепенно: постепенно
потихонечку: потихонечку
похвалить: похвалил
почему: почему
почесть: почестей
почитать: почитать почитаю
появиться: появятся
правда: правда
право: праву
практически: практически
предвкушение: предвкушении
предмет: предметы
предстоять: предстоит
прекрасно: прекрасно
привести: привела
привет: привет
привлечь: привлёк
привнести: привнести
привыкать: привыкаешь
привыкнуть: привыкнуть
приглянуться: приглянулись
пригодиться: пригодится
признаться: признаюсь
призрак: призраком
приключение: приключения
прикольный: прикольных
приколюха: приколюхами
принести: принесли
приносить: приносили
принять: примут
приспособление: приспособления
причём: причём
причёска: причёской
приятно: приятно
приятный: приятная приятной приятную
проблёмкий: проблемкой
провести: проведённое
продолжать: продолжаем
продолжаться: продолжаются
продолжение: продолжение
продолжиться: продолжится
проект: проектах проекте
происходить: происходило происходит
пройти: пройти прошла
прокачаться: прокачаться
пропускать: пропускать
пропустить: пропустите пропустить
проработка: проработки
просить: просил
просто: просто
противник: противнику
профессия: профессия
проявить: проявить
прямота: прямоты
публикация: публикации публикаций
путешествие: путешествие
путь: пути путь
пытать: пытали
пытаться: пытаемся пытаюсь
работа: работу
работать: работающих
равно: равно
радовать: радовать радуют
разбираться: разбиралась
развивать: развивать
разговаривать: разговаривать
различный: различным различными различных
разработчик: разработчики разработчиков
ранний: раньше
рассказать: расскажем
ребёнок: детям
ребёночек: детки
резануть: резануло
резко: резко
рекомендовать: рекомендуем
релиз: релиза
ремейк: ремейк ремейки
ресурс: ресурсы
ретрофутуристический: ретрофутуристической
речь: речи
решить: решила
робот: роботов
ролевый: ролевые
ролик: ролики
российский: российские
рука: рук
русский: русская
рыбка: рыбки
рядовой: рядовыми
сам: самим самого самой
самый: самое самый самыми
сбалансированный: сбалансированную
сверхспособность: сверхспособности
свободный: свободное
свой: своей свои своими свой своё
сделать: сделал
сегодняшний: сегодняшнем
сей: сих
секрет: секрет
секретный: секретный
сериальчик: сериальчик
серия: серии серия
серьёзный: серьёзной
сидеть: сижу
сила: сила
сильный: сильные
синь: синей
сказать: скажу
скидка: скидок
скучноооооо: скучноооооо
сладенький: сладенькое
следить: следить
слишком: слишком
сложно: сложно
сложность: сложность
сложный: сложный
слопать: слопать
слышать: слышала
смерть: смерти
смесь: смесь
смочь: смог
сначала: сначала
снова: снова
собирать: собираем
советовать: советую
сожаление: сожалению
создавать: создавая
создатель: создатели
создать: создали созданного
соответствие: соответствии
сопереживать: сопереживать
составлять: составляющей
соулсова: соулсов
соцсеть: соцсети
сочно: сочно
спасибо: спасибо
спасти: спасти
спать: спать
спешить: спешили
спирт: спиртом
спойлерить: спойлерить
спокойно: спокойно
способность: способность
способный: способен
сразиться: сразиться
сразу: сразу
среди: среди
средний: средней
становиться: становится
стараться: стараешься старались стараюсь
старенький: стареньких
стареть: старею
старинка: старинке
старый: старые
стать: стал стало станут стать
статья: статье статьи статья
стильно: стильно
стим: стим
столкнуться: столкнулась столкнёмся
столько: столько
стратегия: стратегии
стрелять: стрелять
стрим: стрим
строительство: строительства
судить: судить
судьба: судьбами
суетиться: суетиться
супербрутальный: супербрутальный
суперсовременный: суперсовременная
сущность: сущность
схватка: схватка
сценарист: сценаристом
считать: считают
счёт: счёт
сюда: сюда
сюжет: сюжет сюжета
сюжетный: сюжетной
так: т
таки: таки
такой: такие такое
тг: тг
текст: текста
текстурок: текстурках
тело: телом
тема: теме темой тему темы
терпение: терпение
территория: территории
тип: типа
тонна: тонн
топорный: топорным
торопиться: торопиться
тот: те
точный: точная
третий: третьей
тройка: тройка
труд: труд
трудно: трудно
туда: туда
тщательно: тщательно
тяжеловатый: тяжеловато
тёмный: тёмная
убийство: убийством
убить: убил
уворачиваться: уворачиваться
удаться: удалось
удивить: удивили
узнать: узнаем
указать: указана
улыбнуть: улыбнуло
умирать: умирая
уникальный: уникальная
упустить: упустить упущенное
уровень: уровней
усидеть: усидеть
успеть: успели
успешно: успешно
уставать: устаю
фанат: фанатам
фантастика: фантастики
финал: финала
флаг: флаг
хазан: хазан хазана хазану
характеристика: характеристики
хватать: хватает хватало
хидетака: хидетака хидетакой
хит: хита
хитрый: хитрые
ходить: ходить
хождение: хождения
хорошенький: хорошенького
хорошенько: хорошенько
хороший: лучшее лучших хороши
хотеть: хотите хотят хочу
хотеться: хочется
целое: целом
цена: цена
центр: центре
час: часов
частенько: частенько
часто: часто
часть: частей части часть
чей: чья
червь: червей
честно: честно
чинить: чинить
читать: читали
чувствовать: чувствую
шикарно: шикарно
шикарный: шикарен шикарной шикарную
широкий: шире
шутеры: шутеры
экшен: экшен
экшн: экшн
эмоция: эмоций
эпичный: эпичные эпичный
это: это
этот: эта этих
эх: эх
эээ: эээ
ю: ю
юмор: юмор юмором
я: мной
являться: являются
яркий: яркие
