аппаратный: аппаратной
база: базе
безель: безелем
бесконечный: бесконечными
битный: битных
блистер: блистер
боковой: боковым
больший: больших
быть: будут
важный: важные
вакансия: вакансии
вариация: вариаций
версия: версии
весь: весь всем
весьма: весьма
взглянуть: взгляните
взять: взят
владелец: владельцев
внешне: внешне
вновь: вновь
внутнуть: внутни
вовсе: вовсе
вода: воды
возможно: возможно
возможность: возможность
вообще: вообще
востребовать: востребованы
время: времени время
вспомнить: вспомнить
выдерживать: выдерживают
выполнить: выполнен
геймдева: геймдев
глубина: глубину
год: года годах
два: двум
денди: денди
джойстик: джойстика
дзен: дзен
дзеневакансиидзен: дзеневакансиидзен
диск: дисках
дисплей: дисплеем
документ: документы
долгий: долгое
доставать: доставать
доступный: доступны
другой: другие
железо: железом
забыть: забыли
задумываться: задумывались
запаковать: запакованных
запустить: запустить
засыпать: засыпать
защитить: защищены
звук: звуков
здоровье: здоровья
знак: знаком
игра: игр играми игры
игровой: игровой игровые игровых
игрыроссийский: игрыроссийские
игрыэкшн: игрыэкшн
измениться: изменилась
индустрииигра: индустрииигры
интересуютсяследить: интересуютсяследить
каждый: каждой
какой: какие какими
калория: калорий
канал: канал
капот: капотом
киберспортодиночный: киберспортодиночные
килобайт: килобайт
клавиатура: клавиатурой
классический: классическим
клон: клонов
кнопка: кнопкам
кнопочный: кнопочных
количество: количество
коллекция: коллекции
компания: компании компания
комплектующиешутерымногопользовательский: комплектующиешутерымногопользовательские
компьютерный: компьютерные компьютерных
консолигаджет: консолигаджеты
консоль: консолей консоли консоль
контакт: контакты
копирование: копирования
коробка: коробку
корпус: корпуса корпусами
который: который
культовый: культовые
лицензионный: лицензионных
любовный: любовное
магазин: магазине
месяц: месяц месяца месяцев
металлический: металлическим
мина: мин
минутыма: минутымой
мир: мир миры
млн: млн
многие: многие
множество: множестве
мобильный: мобильные мобильный
набор: набор
назадподписатьсягеймдеть: назадподписатьсягеймдев
назадподписатьсястарый: назадподписатьсястарые
назадподписатьсячтый: назадподписатьсячто
найти: найти нашел
наличие: наличию
намеренно: намеренно
начать: начнем
начаться: началось
наш: наших
небольшой: небольшим
несколько: несколько
никто: никому
новый: новые
нужный: нужны
нулевой: нулевых
нулевыхдрузие: нулевыхдрузья
объём: объемах
один: одного одной
одноимённый: одноименную
определить: определят
оригинал: оригинала
оригинальный: оригинального
основа: основу
отличный: отличная
память: памяти
пара: парой
письмо: письмо
плата: плат платы
площадка: площадки
погружение: погружение
подсчитать: подсчитают
позволять: позволяет
пойти: пошло
поклонник: поклонникам
покупать: покупать
помимо: помимо
помнить: помните
последний: последнее
посмеяться: посмеются
постоянный: постоянными
похоже: похоже
прародитель: прародитель прародителя
предзаказ: предзаказу
предлагать: предлагаю предлагают
представить: представила
представлять: представлял
привязать: привязано
пригодиться: пригодится
признаться: призналась
прилавок: прилавка
приставка: приставок
продавать: продавал
произойти: произошло
пройти: пройденных
пропустить: пропустите пропустить
процессор: процессоров
прочий: прочих
публикациина: публикациине
публикацииподписатьсярекомендовать: публикацииподписатьсярекомендуем
пульс: пульс
путь: пути
пыль: пыли
работать: работали
разбираться: разбирался
развиваться: развиваться
разный: разными
разработчик: разработчики
ранний: раньше
рассказать: расскажу
ретро: ретро
ретроигра: ретроиграм
ролевый: ролевые
руб: руб
рубль: рублей
сайт: сайте
сам: сами самого
свой: своё
сделать: сделано
сегодняшний: сегодняшней
сенсорный: сенсорный
сжечь: сожженных
ситуация: ситуация
сказать: сказать
склад: складе
скопировать: скопирован
слабый: слабым
слово: словам
сменный: сменный
снова: снова
событие: события
создатель: создателей
сообщение: сообщениями
сотня: сотен
сохранить: сохранить
средний: средний
стандарт: стандарту
старый: старый
стилистика: стилистике
стоять: стояли
стратегия: стратегии
существовать: существуют
такой: такие
телефон: телефон телефонах
тема: темой темы
темувидеостатьироликиновостивидеоигрыдетямвсё: темувидеостатьироликиновостивидеоигрыдетямвсё
темувойтиглавнаяподпискинайти: темувойтиглавнаяподпискинайти
темуигровой: темуигровые
темыгеймингтехнология: темыгеймингтехнологии
торрент: торренты
тот: тех
тыс: тыс
убрать: убрал
удешевление: удешевления
узнать: узнать
уместить: уместить
умудряться: умудрялись
управление: управление
устройство: устройство
фотография: фотографии
функция: функциями
хотеть: хотеть хочет
целый: целые
цена: цене
циферблат: циферблатов
цифровой: цифровые
час: часов
часы: часах часы часыа
четыре: четыре
читать: читали
шаг: шагов
экран: экран
электроникановинка: электроникановинки
это: это
этот: этих
