ааа: ааа
абсолютно: абсолютно
абсолютный: абсолютные
автомобиль: автомобиль автомобиля
автор: автором авторы
агрессивный: агрессивными
актёр: актер актеров актеры актёр актёра актёров
английский: английский
анимация: анимации
археолог: археологов
безымянног: безымянногов
безымянный: безымянного
бельчонок: бельчонка бельчонок
бесконечный: бесконечный
бестюн: бестюн
благодаря: благодаря
богатый: богаче
болеть: болел
боль: боль
больший: большую
большой: большое большой
бояться: боюсь
бросить: бросить
будущее: будущее будущем
бульдог: бульдога
бывало: бывало
бывать: бывает бывали бывать бывают
быть: буду будут
бэстьюн: бэстьюн
вакансия: вакансии
вариант: вариант
вася: вася
ваш: вашей ваши ваших
везде: везде
верить: верю
вернуться: вернулся вернуться
версия: версию
вести: вел
весь: всем
весёлый: веселым
вжиться: вжиться
взглянуть: взгляните
взять: взял взяли возьму
видеоигра: видеоигры
видеть: видел видит видишь вижу
видимо: видимо
вирусный: вирусной
включая: включая
владелец: владельцу
вместе: вместе
водоворот: водоворот
возможность: возможность
вокруг: вокруг
вообще: вообще
вопрос: вопрос вопросов вопросы
восьмой: восьмые
впервые: впервые
время: время
времярынок: времярынок
всевластие: всевластия
вслепую: вслепую
вспомнить: вспомнить
всё: всё
второй: вторая вторую
входной: входные
выбирать: выбирать
выбор: выбор
выпиливать: выпиливать
вырасти: вырос выросло
выход: выход
выходить: выходят
выходной: выходные
вяло: вяло
гадость: гадость
геймер: геймеров
геймплей: геймплей
генерация: генерацию
генерировать: генерированным
герой: героев герои герой героя
глава: глава
главное: главного главное
главный: главной главный главных
гланец: гланцем
гланца: гланц
гланцемма: гланцеммы
гланцпетра: гланцпетр
говорить: говорил говорит говорить говоришь говоря говорят
говорящий: говорящего
год: года годы лет
голлум: голлум
голова: голову
голос: голос голоса голосами голосе голосом
гораздо: гораздо
государство: государство
готика: готика готике готику
готовый: готовую
графика: графики графикой
группа: группа
давать: дают
давно: давно
далее: далее
далёкий: дальше
дать: дали данные даны
дача: дачу
два: две
двадцать: двадцать
движение: движения
двухтысячный: двухтысячных
дебютировать: дебютировал
девяностый: девяностых
девятый: девятые
делать: делаешь делайте делал делали делать делают
дело: деле дело
день: день дня
деньга: денег
десятка: десяткам десятки десяток
детство: детстве
дзен: дзен
дзеневакансиидзен: дзеневакансиидзен
диалог: диалогах
дипфейк: дипфейк
дискета: дискету
добрый: добрым
довзрослеть: довзрослел
доказательство: доказательство
документ: документы
долго: долго
должный: должны
дом: дома
дополнительный: дополнительные
дорогой: дорогих
доставлять: доставляет доставляло
достаточно: достаточно
доступность: доступности
древний: древние
друг: друзьям
другой: другим другими других
дубляж: дубляжа
дубляжом: дубляжом
дуга: дугой
думать: думаю
дэдпул: дэдпул дэдпула дэдпулом
еврейский: еврейского еврейской
египет: египет
единственный: единственный
жадный: жадных
жаль: жаль
жанр: жанр
жизнь: жизнь
жёлудь: жёлудем жёлудь
забавно: забавно
завируситься: завирусился
зависеть: зависит
завладеть: завладеть
загрузить: загрузил загрузили
задавать: задают
задать: задали
задача: задачу
задумываться: задумывались задумываясь
заинтересоваться: заинтересоваться
закончиться: закончилась
замечательный: замечательно замечательного замечательной
занести: занесло
занимать: занимает занимать
заниматься: занимаетесь заниматься занимаюсь занимаются
занятный: занятных
заняться: занялись занялся
записать: записанный записать
записывать: записывал записывать записывают
запомниться: запомнился
захват: захватом
захотеть: захотели
зачитывать: зачитывали
защищать: защищают
звать: зовет
звук: звук
звучать: звучит
звёздочка: звездочкой
здорово: здорово
злой: злым
знакомый: знакомый
знание: знаний
знать: знаете знаешь знаю знают
зря: зря
игра: игр игра играм играх игрой игру игры
играть: играл играли играть
игровой: игровая игровой игровые игровых
игрок: игроков
игрыроссийский: игрыроссийские
игрыэкшн: игрыэкшн
идеальный: идеальная
идея: идеи
известный: известен известных
издатель: издателей
измениться: изменилось
изнутри: изнутри
именно: именно
индустрииигра: индустрииигры
индустрия: индустрии индустрия
интерактивный: интерактивном
интервью: интервью
интерес: интерес
интересно: интересно
интересный: интересная интересное
интересовать: интересовал
интересуютсяследить: интересуютсяследить
интернет: интернете
интонация: интонациях
исключительно: исключительно
исполнить: исполнить
исправить: исправили
история: история
итак: итак
итог: итоге
ия: ии
каждый: каждая каждого каждый
казаться: кажется
казахстан: казахстане
кайф: кайф
какой: какие каким какими
канал: канал каналах
картинка: картинка
карьера: карьеру
кейнать: кейнав
киберспортодиночный: киберспортодиночные
кинематографичность: кинематографичность
кино: кино
киношный: киношный
класс: класса
книга: книги
код: код кодов
кой: коего
коллега: коллег коллеги
кольцо: кольцо
комикс: комиксов
компания: компании компаний компанию
комплектующиешутерымногопользовательский: комплектующиешутерымногопользовательские
компьютерный: компьютерной компьютерные
комфортный: комфортнее
конец: конце
конкретно: конкретно
консолинайти: консолинайти
контакт: контакты
контроль: контроль
косяк: косяки косяков
который: которая которого которой котором которому которую которые который
красивый: красивее красивую красивыми
кровь: крови
крупный: крупного крупной крупные
круто: круто
крутой: крутую
кто: кого
культовый: культовым
лапа: лап
ледниковый: ледникового ледниковый
либо: либо
лицевой: лицевой
лицо: лица лицом
лишь: лишь
локализация: локализаций локализация
локкит: локкиты
лукас: лукаса
лунный: лунный
любимый: любимых
лёгкий: легче
маленький: маленьких маленькую меньше
мама: мама
марк: марк
марка: марки
массивный: массивнее
материал: материал
машина: машин
маяковский: маяковский маяковского
мебель: мебель
медиа: медиа
менее: менее
менять: менять меняют
место: место
месяц: месяц месяца
механик: механик
механика: механика механики
мимика: мимике
минимально: минимально
минимум: минимум
минкультовый: минкультовый
минута: минуты
минутгерман: минутгерман
млн: млн
многий: многим многих
множество: множеством
мобильный: мобильной мобильные мобильных
мой: моего мои моим мою
момент: момент моменты
мочь: мог могу
музыка: музыкой
мультипликационный: мультипликационных
мультфильм: мультфильмах
мы: нам
н: н
наверное: наверное
навскидку: навскидку
надежда: надежда
надеяться: надеюсь
назад: назад
назадподписаться: назадподписаться
назадподписатьсять: назадподписатьсяя
название: название
назвать: назвать
называться: называется
найти: найдет найти
наперекор: наперекор
написание: написание написанием
написать: написать
например: например
насколько: насколько
настаивать: настаивал
настоять: настояли
научиться: научились
начало: начале
начать: начал
начинать: начинаешь начинаю
наш: наши наших
нащупать: нащупана
наёмник: наёмником
неверно: неверно
невинный: невинные
недалеко: недалеко
неделя: неделю
нейросеть: нейросетей
некоторый: некоторые некоторых
немой: нем
необычный: необычный
неофициальный: неофициальным
непохожий: непохожий
неправильно: неправильно
непросто: непросто
несколько: нескольким несколько нескольку
несмотря: несмотря
неудача: неудачу
никак: никак
никакой: никакой
никто: никто
ничто: ничем
новый: нового новое новую новые
нравиться: нравилось нравится
нужно: нужно
обеспокоить: обеспокоены
обзор: обзор
образ: образах образов
образование: образованию
обратный: обратная
общий: общем
объём: объёмах
обязательно: обязательно
оглядываться: оглядываетесь
огромный: огромный
один: одним одной одну
озвучание: озвучания
озвучивать: озвучивает озвучивал озвучивали озвучивать
озвучиваться: озвучивается
озвучить: озвучил озвучили озвучить
озвучка: озвучке озвучкой
ой: ой
окончательно: окончательно
он: нему
они: ими
оно: оно
опасность: опасности опасностью
оригинал: оригинал оригинале
ориентироваться: ориентировался ориентироваться
ортодокс: ортодоксы
оскорбление: оскорбление
основное: основном
особенно: особенно
особо: особо
особый: особое особой
оставаться: остается остаются
оставить: оставить
оставять: оставяем
остальной: остальные
остаться: осталось
ответ: ответа ответы
ответить: ответил
отдельно: отдельно
отдельный: отдельный
отличаться: отличается
относиться: относитесь
отпуск: отпуске
отрицательно: отрицательно
официально: официально
официальный: официальной официальные официальных
очень: очень
палитра: палитра
паразитировать: паразитировать
первый: первую
перевести: переведена перевести
перевод: переводы
переводный: переводные
переводчик: переводчики
перед: передо
переделать: переделали
переживание: переживания
переживать: переживаете
перейти: перешла
переписать: переписали
переполненный: переполнен
перепрыгнуть: перепрыгнул
перехватить: перехватили
период: период периода
персонаж: персонаж персонажа
печалить: печалит
пиз: пиз
писать: писал писали писать пишет
план: плане
платить: платят
плечо: плечо
плохо: плохо
плохой: плохие плохого плохой худшие хуже
плюс: плюс
повезти: повезет
повлиять: повлияло
подавать: подают
подарить: подарили
подготовить: подготовить
подобный: подобное подобному
подписаться: подпишитесь
подписчиковподписаться: подписчиковподписаться
подходящий: подходящее
подчас: подчас
подыгрывать: подыгрывая
поехать: поехали
позвать: позвать позовут
поздноватый: поздновато
позор: позор
пойти: пойду пошел
пока: пока
показать: показаны
полагать: полагаю
полный: полным
получаться: получается
получить: получили
получиться: получилась получилось
пользоваться: пользоваться
полюбиться: полюбившегося
поменять: поменял
помнить: помню
помогать: помогаю
помочь: помогло
помощь: помощью
поначалу: поначалу
понимание: понимания
понимать: понимаешь понимали понимаю
понравиться: понравилось понравится
понятный: понятное
понять: понял поняли
пообщаться: пообщались
попадаться: попадался
попробовать: попробовать
популярный: популярных
поработать: поработать
порог: порога
порой: порой
последний: последнее последние
посмотреть: посмотрели посмотрим
посредственный: посредственной
потерять: потерял
поучаствовать: поучаствовал
похоже: похоже
почему: почему
поэтому: поэтому
появиться: появятся
появление: появление
появляться: появляются
правда: правда
правильно: правильно
право: права
практически: практически
предназначить: предназначена
предпочитать: предпочитаете
предыдущий: предыдущие
прекрасно: прекрасно
прекрасный: прекрасного
придумываться: придумывается
прийтись: пришлось
прим: прим
примечательный: примечательный
принцип: принципе
природа: природе
присылать: присылают
приходить: приходит приходишь
приходиться: приходилось
причина: причинам причине
причём: причем
приёмка: приемке
проверить: проверили
программа: программ
программист: программист
программный: программный
продолжать: продолжают
продукт: продукта
проект: проект проекта проектами проекте проекту проекты
производить: производит производящие
производиться: производится
произношение: произношении
происходить: происходит
пропустить: пропустите пропустить
пророчить: пророчила
проследить: проследить
простенький: простенькие простенькую
простой: простой проще
против: против
профессионал: профессионалы
профессиональный: профессиональной
профессия: профессией профессии профессию
процент: проценты
процесс: процесс процессе
прочее: прочее
прошлый: прошлом
прям: прям
прямо: прямо
публикациина: публикациине
пускай: пускай
пусть: пусть
пытаться: пытался
пётр: петр петром
работа: работа работу работы
работать: работает работаешь работаю работают
равно: равно
ради: ради
развиваться: развивается развиваться
развитие: развитием развитии развитию
развлекательный: развлекательный
разделяться: разделяется
раздразнить: раздразнили
разный: разных
разобраться: разобрались
разочароваться: разочаруюсь
разочаровываться: разочаровывались
разработать: разработанных
разработчик: разработчиком
разум: разуму
рамка: рамках
ранний: раньше
раскрутиться: раскрутиться
раскрутка: раскруткой
расти: расти растут
рваться: рвался
реально: реально
ребята: ребята
ревновать: ревнуете ревную
ревность: ревности
регулировать: регулировать
ред: ред
режиссёр: режиссер режиссера режиссёра
результат: результат
реклама: реклам реклама рекламе рекламу
ремейк: ремейка ремейком
реплика: реплики
репутация: репутации
решение: решение
решить: решил решили
рисовка: рисовка
роберт: роберта
ролевый: ролевые
ролик: ролик ролики
роль: ролей
российский: российская российской
рука: руки
русский: русская русский
русый: русы
рф: рф
рынок: рынка
рыцарь: рыцарь рыцаря
рыцарьпусть: рыцарьпусть
ряд: ряд
сайт: сайты
сам: сами самого самом
самый: самая самое самые самый самых
светить: светил
свободный: свободное
свой: свое своей своему своим своих
связанный: связанный
сгенерировать: сгенерированным
сгенерить: сгенерить
сделать: сделали сделан сделана сделаны сделать
седьмой: седьмые
семья: семье
сергей: сергея
сердце: сердцах
сериал: сериал сериала сериалах сериалы
серия: серии
серьёзный: серьезную серьезные серьезным серьезных
сесть: сяду
сильно: сильно
симулятор: симуляторы
ситуация: ситуаций ситуацию ситуация
скажем: скажем
сказать: сказал сказать
сказаться: скажется
сколько: сколько
скорее: скорее
скрат: скрат скрата
скриптить: скриптить
слепок: слепок
слиться: слилось
сложно: сложно
сложный: сложнее
случай: случае
слушать: слушал слушать
слышать: слышал слышали слышать слышу
смешной: смешное
смотреть: смотрел
смысл: смысле
снова: снова
собраться: собрались
событие: событий
соведущий: соведущим
совершенно: совершенно
современный: современных
согласиться: согласились
соглашаться: соглашаешься
сожаление: сожалению
создавать: создавать
создать: создать
соответственно: соответственно
состариться: состарюсь
состояние: состояния
сочный: сочное
спарта: спарта
спасать: спасать
спектор: спектор
спецэффект: спецэффекты
спокойно: спокойно
спрашивать: спрашивают
спустя: спустя
ссылка: ссылку
стандартный: стандартная
становиться: становятся
становление: становление
стараться: старается стараюсь
старший: старше
старый: старыми
стать: стал стали стало
сторона: стороны
стратегия: стратегии
страшный: страшен
стремительный: стремительном стремительному
строго: строго
студия: студии студий студия
суд: суд
супергерой: супергероя
сценарий: сценариев сценарием сценарии
счёт: счёт
съёмка: съемки
сыграть: сыграв сыграл
таки: таки
такой: такая такие таких такого такое таком
твой: твоего твой твою
текст: текста тексте текстов тексты
тема: теме
темувидеостатьироликиновостивидеоигрыдетямвсё: темувидеостатьироликиновостивидеоигрыдетямвсё
темувойтиглавнаяподпискинайти: темувойтиглавнаяподпискинайти
темуновинка: темуновинки
темыгеймингигровый: темыгеймингигровые
терпеть: терпел терпеть
технология: технологии технология
толкать: толкает
тот: та те тех тому
точнее: точнее
точно: точно
тратить: тратили
трейлер: трейлерами трейлеры
трястись: трясутся
трёхдюймовый: трёхдюймовую
ты: тебе
тыс: тыс
угодный: угодно
удивительный: удивительного
удобно: удобно
удобный: удобнее
удовлетворение: удовлетворения
удовольствие: удовольствие удовольствием удовольствия
ужасный: ужасные
узнать: узнали
уйти: ушел
улица: улице
уникальный: уникальных
упразднить: упразднена
ускользать: ускользал
условный: условную
успеть: успели
устать: устал
уступать: уступают
уход: ухода
участвовать: участвовал
учиться: учиться
факт: фактов
фанат: фанаты
фанатский: фанатские фанатскими
фейковый: фейковых
фильм: фильм фильмам фильмах фильме фильмов фильмы
финальный: финальная финального
фраза: фразу
французский: французского
хирург: хирургом
хлебнуть: хлебнул
холмс: холмсу
хороший: лучшего лучшей лучшими хорошего хорошей хороший
хотеть: хотели хочу
хотеться: хотелось хочется
хотя: хотя
художественный: художественных
целое: целом
целый: целый
часто: часто
частый: чаще
часть: часть
человек: людей люди человек
честно: честно
читать: читали
чонишвили: чонишвили
чувствовать: чувствую
шерлок: шерлоку
шестой: шестой
экран: экран экране
эмоция: эмоций эмоциях
эстафета: эстафету
это: этим это
этот: эта этими этому
эффект: эффекты
я: мной
являться: является
явно: явно
яркий: яркий яркими
