автономный: автономных
адаптироваться: адаптироваться
активность: активности
архитектура: архитектурой
аудиосистема: аудиосистемы
аудитория: аудитория
битва: битву
вакансия: вакансии
вдвое: вдвое
версия: версией версии версий версию
весы: весы
взглянуть: взглянем взгляните
видео: видео
видеоигра: видеоигры
видеокарта: видеокарт видеокарта видеокартах видеокарту видеокарты
видеопамять: видеопамяти
включить: включить
возможность: возможностью
войти: войти
время: время
вступать: вступает
всё: всё
вчера: вчера
выбрать: выбрать
выдавать: выдавать
вылиться: выльется
выпустить: выпустила
выходить: выходит
гаджет: гаджеты
гб: гб
гейминг: гейминг
геймплей: геймплей
генеративный: генеративного
главный: главная
год: год года году
горячий: горячую
готовить: готовит
готовый: готовы
гп: гп
графика: графика
графический: графические графических графического графическую
давать: давайте
два: две
действительно: действительно
демонстрировать: демонстрирует
детальный: детальное
дзен: дзен дзене
добавить: добавлены
добавлять: добавляет
документ: документы
драйвер: драйвер драйвера драйвере драйверов
другой: других
единственный: единственная
ещё: ещё
её: её
железо: железа
завалиться: завалившийся
зависимость: зависимости
задача: задачи
замедление: замедления
заменять: заменять
замещение: замещение
значок: значок
игра: игр играх игры
игровой: игрового игровой игровые игровых
известный: известные
изменение: изменение изменении
изображение: изображения
иметь: имеет
интегрировать: интегрирована
интеллектуально: интеллектуально
интересный: интересных
интересоваться: интересуются
использование: использованием использовании
исправить: исправлена исправленных
источник: источник
ия: ии
камера: камеры
канал: канал
карта: карт карту
качество: качество
китайский: китайское
книга: книги
колонка: колонки
компания: компания
компиляция: компиляции
консоль: консоли
контакт: контакты
конференция: конференции
который: которое которой которую
луна: луне
любой: любые
маркет: маркет
масштабирование: масштабирования
мгц: мгц
месяц: месяца
мина: мин
минута: минута минуты
мир: мире
млн: млн
мобильный: мобильных
модель: модели модель
модуль: модуль
монстр: монстры
мочь: мог могли могут
мощный: мощную мощным
назад: назад
найти: найти
настройка: настройки
наушник: наушники
начало: начала
начать: начали
начинаться: начинается
незначительно: незначительно
нейронный: нейронного
некоторый: некоторые
новость: новостей новости новость
новый: новая новейшие новую новые
ноутбук: ноутбуки ноутбуков
обеспечить: обеспечить
область: области
обновить: обновлены
обновление: обновление обновления
оборудование: оборудование
обусловить: обусловлено
огромный: огромный
одиссей: одиссей
ознакомиться: ознакомиться
окружение: окружение
оператор: операторы
оптимальный: оптимальную
оптимизировать: оптимизирует
опция: опции
оснастить: оснащенную
отечественный: отечественным
отличаться: отличаться
отображать: отображать
отраслевой: отраслевые
официальный: официального
ошибка: ошибка ошибку
пакет: пакет
перезагрузка: перезагрузки
персонаж: персонажей
пк: пк
плавный: плавный
планшет: планшеты
победитель: победителем
повысить: повышена
погибнуть: погибнуть
поддержка: поддержкой поддержку
подписаться: подписаться подпишитесь
подписка: подписки
подписчик: подписчиков
позволять: позволяет
поколение: поколения
полный: полной полные полным
польза: пользу
помочь: помочь
поток: потока
почитать: почитать
появление: появлением
предназначить: предназначена
предоставлять: предоставляет
представить: представила
представлять: представляет
прежде: прежде
презентация: презентация
приготовиться: приготовьтесь
приложение: приложение приложения
примечание: примечание
принести: принёс
принудительно: принудительно
прирост: прирост приросту
проблема: проблем проблемы
провести: проведем
программный: программные
продемонстрировать: продемонстрировал
производитель: производитель производителя
производительность: производительности производительность
пропустить: пропустите пропустить
против: против
процесс: процесса
процессор: процессоров
прошлый: прошлом
публикация: публикации
работать: работать
радиоастрономия: радиоастрономии
раз: раза
разгон: разгоне
разгромить: разгромить
разрешение: разрешении
рассмотреть: рассмотрим
реагировать: реагировать
реалистично: реалистично
ребёнок: детям
регион: региона
режим: режим
рейтинг: рейтинги
рекомендовать: рекомендуем
рендеринг: рендеринга
ролик: ролики
российский: российские
россия: россии
сайт: сайта сайте
сбой: сбои
сбрасываться: сбрасываться
свежий: свежем свежий
связь: связи
себя: собой
сегодня: сегодня
серия: серии
сила: силу
система: системы
скачать: скачать
скорость: скорости
следить: следить
следующий: следующего
смартфон: смартфоны
создание: создания
сократиться: сократилась
состояние: состояния
список: списком список
способный: способна
сравнение: сравнение сравнению
сразу: сразу
стабильность: стабильность
статья: статье статьи
также: также
тактовый: тактовую
текстура: текстуры
тема: темой тему темы
технический: технические технического
технология: технологии технологию технология
трекер: трекеры
тыс: тыс
уведомление: уведомлений
узнать: узнаем
улучшать: улучшает
улучшить: улучшенные
умный: умные
упоминать: упоминает
ускорение: ускорение
установка: установке
фитнес: фитнес
фототехник: фототехника
характеристика: характеристик характеристики
цена: цены
частота: частоту
часы: часы
читать: читайте читали
чёрный: чёрным
шутеры: шутеры
экран: экраном
электроника: электроника
электронный: электронные
энергопотребление: энергопотребления
эра: эра
это: это
яндекс: яндекс
