автомат: автоматов
ад: ада
азарт: азарт
аксессуар: аксессуары
аргументированно: аргументированно
артефакт: артефактов
аспект: аспектам
бесполезный: бесполезный
бой: боем боя
бонус: бонусы
бункер: бункеры
быть: будем
важный: важные
вакансия: вакансии
ваш: ваша
введение: введение
взглянуть: взгляните
взращивать: взращивает
видео: видео
видеоигра: видеоигры
вкус: вкусы
вне: вне
внимание: внимания
возможность: возможности возможность
войти: войти
вообще: вообще
вооружение: вооружения
воспоминание: воспоминания
вперёд: вперёд
впечатление: впечатлениями
время: время
всевозможный: всевозможные
встречаться: встречающихся
всё: всё
вторичный: вторичных
выразить: выражу
выучить: выучить
вышка: вышек
гейминг: гейминг
герой: героем герой героя
главный: главная главный главным
говорить: говорю
год: год году
головоломка: головоломка головоломок
горожанин: горожан
давать: давайте
далеко: далеко
два: две двух
дейли: дейли
действие: действие
день: дня
детектив: детектив
детский: детский детских
детство: детства
джевеловый: джевелов
джек: джек
джон: джон джона
дзен: дзен дзене
днайва: днайв
добавить: добавив
документ: документы
долгий: долгое
дом: дом
дополнение: дополнений
дополнительный: дополнительных
достижение: достижения
друг: друзья
думать: думал
ещё: ещё
её: её
жанр: жанре
жизнь: жизнь
забегать: забегая
заклинание: заклинания
заслуживать: заслуживает
зацепить: зацепило
зло: зла
знать: знаю
зоркость: зоркость
ибо: ибо
игра: игр игра игре игру игры
играть: играть
игровой: игровой игровые игровых
игрок: игроку
игрушка: игрушка
идеальный: идеальный
издавать: издавала издавали
издание: издания
издатель: издателем
издательство: издательств
издать: изданная изданные
изменение: изменения
именно: именно
иметь: имеют
иметься: имеющиеся
индустрия: индустрии
инструмент: инструмент
интересоваться: интересуются
использовать: используют
история: истории
итог: итог
каждый: каждого
канал: канал
карвера: карвер
качественный: качественных
киберспорт: киберспорт
книга: книг
колдовство: колдовстве
комикс: комиксов
компания: компанией
комплектующие: комплектующие
компьютерный: компьютерной компьютерную компьютерные компьютерных
конкуренция: конкуренции
консоль: консоли
константин: константин
контакт: контакты
кончиться: кончились
коснуться: коснулись
который: которая которые
красивый: красивее
критик: критиков
кронверк: кронверк
лайк: лайки
лежать: лежит
локализовать: локализованные локализованным
магия: магия
мало: мало
меняться: менялись
мертвяк: мертвяков
месяц: месяц месяцев
механика: механику
меч: меч
мина: мин
минута: минут минуты
мир: мире
миссь: мисси
млн: млн
многопользовательский: многопользовательские
мобильный: мобильные
мой: мои
монстр: монстров
мотив: мотивам
мочь: можем
навык: навык навыках навыки навыков
надоедать: надоедает
назад: назад
название: название названием названия
назвать: назвать
называть: называть
найти: найти
наличие: наличие
находить: находя
начало: начало
начинать: начинал
наш: наш
невозможно: невозможно
независимо: независимо
неизвестный: неизвестным
некоторый: некоторым некоторых
немного: немного
необходимо: необходимо
несколько: несколько
новинка: новинки
новость: новости
новый: новые
обзор: обзоре
обложка: обложка обложке обложки
обратный: обратная
общий: общего общем
объединяться: объединяются
оглавление: оглавление
один: одним одно
одиночный: одиночные
однако: однако
однозначно: однозначно
однообразный: однообразна
оккультист: оккультист
оригинал: оригинал
оружие: оружие оружии оружия
основа: основе
основательный: основательной
основное: основном
оставаться: остаётся
остаться: остался
отдельный: отдельных
отзыв: отзывы
отличаться: отличается
отстреливать: отстреливать
отсутствие: отсутствие
официально: официально
официальный: официальное
очень: очень
ошибаться: ошибался
первый: первая первой первых
переработка: переработке
пират: пиратами
пиратский: пиратских
повелитель: повелитель
подборка: подборки
подвергнуться: подверглись
поделиться: поделиться
подписаться: подписаться подпишитесь
подписка: подписки
подписчик: подписчика
позволить: позволит
показать: показать
положительный: положительный
получить: получил получила
получиться: получилась
попутно: попутно
пора: пор
портировать: портирована
посланник: посланник
последний: последней
пост: пост
постараться: постараюсь
постичь: постигли
почему: почему
почитать: почитать
пощупать: пощупать
поэтому: поэтому
появиться: появиться
превосходить: превосходит
предназначение: предназначения
представить: представлена
предшественница: предшественниц
прежде: прежде
прежний: прежним
приведение: приведениями
приключение: приключения
применяться: применяется
присутствовать: присутствуют
причём: причём
продлевать: продлевают
происходить: происходит
пройти: пройти
пропустить: пропустите пропустить
простить: простите
протагонист: протагонист
противостояние: противостояние
прохождение: прохождения
процесс: процесс
публикация: публикации
путь: путями
пятый: пятой
ради: ради
разворот: разворота
различный: различными
разнообразный: разнообразнее
разработать: разработанная
рассмотреть: рассмотрим
ребёнок: детям
революционный: революционными
режим: режимов
рекомендовать: рекомендуем
ролевый: ролевые
ролик: ролики
российский: российские
россия: россии
русский: русском
сам: самой
сверхъестественный: сверхъестественное
свет: свет
свой: своей своему своих
свойство: свойство
связываться: связываться
сделать: сделали
себя: собой
сей: сих
сектант: сектанты
сердце: сердцем
серия: серии
сила: силами
симулятор: симуляторы
сказать: скажу
скорее: скорее
следить: следить
слово: словом
сложный: посложнее
смешанный: смешанные
совершенно: совершенно
современный: современном
солдатик: солдатиков
сохранить: сохранил
спасать: спасая
спасение: спасению
средний: средние
ставить: ставим
стать: стали
статья: статье статьи
сторона: сторона
стратегия: стратегии
суть: сути
существенно: существенно
существенный: существенная
считать: считаю
сюжет: сюжета
также: также
такой: такие таким
тема: темой тему темы
тот: те
точно: точно
третий: третьей
три: трёх
триада: триады
тыс: тыс
тьма: тьмы
увеличить: увеличив
увидеть: увидел
увлекать: увлекает
указать: укажи
уникальный: уникальной уникальным
условный: условного
успеть: успел
успешный: успешной
фанатский: фанатским фанатских
физически: физически
фирма: фирма
фото: фото
хардкорщик: хардкорщиках
хороший: лучшая лучшим
хотеть: хотел
целое: целом
цель: целей целях
часть: частей часть
челленджа: челленджа
человечество: человечества
четвёртый: четвёртой
чистый: чистым
читать: читали
шанс: шанс
шпионить: шпионю
шутеры: шутеры
щёлкнуть: щелкни
экипирование: экипированию
экшн: экшн
это: это
язык: языке
