абсолютно: абсолютно
авоська: авоська
аксессуар: аксессуары
акт: акта
алхимический: алхимической
банальный: банальным
бегать: бегаешь бегать
бедно: бедно
бездонный: бездонная
боевой: боевая боевой
божена: божена божену
бой: бой бою
боль: боль
больший: большие
большой: большому
бонус: бонусы
буквально: буквально
бывать: бывает
быстро: быстро
быть: будете
бюджет: бюджета
важный: важнее
вакансия: вакансии
ваш: вашему вашим ваших
ведьмак: ведьмак
везде: везде
вернуться: вернуться
версия: версии
вести: ведет
весь: весь всем
вещь: вещи
взаимоотношение: взаимоотношений
взгляд: взгляд
взглянуть: взгляните
взяться: взяться
видео: видео
видеоигра: видеоигр видеоигры
видеть: вижу
видный: видны
винить: винят
влияние: влияние
влиять: влияем влияющему
вносить: вносят
возможность: возможности
войти: войти
вообще: вообще
воровка: воровке
вперёд: вперед
время: времен времени время
вроде: вроде
вселенная: вселенной
встречать: встречая
вступать: вступать
всё: всё
вторичный: вторичным
второе: второе
второй: вторых
второстепенный: второстепенный
выбор: выбору
выборы: выборов
выбрать: выбраны
выверить: выверен
выглядеть: выглядит
выдать: выдать
выжить: выжить
вынести: вынесены
высказать: выскажу
высокий: высокой
выход: выход
выясниться: выяснится
геймер: геймер
гейминг: гейминг
геймплей: геймплей геймплея
геймплейный: геймплейные
герой: героя
главное: главного
главный: главная
глубокий: глубже
говорить: говорить
год: лет
головной: головную
гораздо: гораздо
давать: давайте давала дают
давний: давнего
давность: давности
данный: данный
два: двух
делать: делать делающих
день: дня
деньга: деньги
деревня: деревне
десятилетие: десятилетие
десятилетний: десятилетней десятилетняя
десять: десяти
дзен: дзен дзене
диаблоида: диаблоид
дикий: дикая
дилогия: дилогия
длинный: длинный
добавочный: добавочные
дойти: дойдя
документ: документы
дополнительно: дополнительно
дополнительный: дополнительных
достаточно: достаточно
достоверный: достоверный
доступ: доступ
дочь: дочь
драка: драки
думать: думаем
ещё: ещё
её: её
жаловать: жалуют
жизнь: жизни
забрасывать: забрасывал
забыть: забудь
зависимость: зависимости
задание: задания
закликивательный: закликивательных
заколебаться: заколебался
заметный: заметна
замок: замком
записка: записки записок
заполнение: заполнения
заскучать: заскучать
заставлять: заставляет
зачистить: зачистить
заявить: заявивших
знать: знаем
игра: игр игра играм играх игре игрой игру игры
играть: играешь играть играя
игровой: игровой игровые
игрок: игроки
изучить: изучить
именной: именных
иметься: имеется
инвентарь: инвентари инвентаря
индивидуальный: индивидуальных
индро: индро
индустрия: индустрии
интерес: интереса
интересный: интересное интересный интересных
интересоваться: интересуются
информация: информация
исторический: исторические
история: история
каждый: каждого каждой каждый
казаться: казалась
казуальный: казуальным
каменный: каменные
канал: канал
карман: карманами карманов
качество: качество
квест: квест квестов квесты
кибер: кибер
киберспорт: киберспорт
классический: классическая классический
клубок: клубок
книга: книг книги
количество: количества
комбинация: комбинациях
комплектующие: комплектующие
консоль: консоли
контакт: контакты
контент: контент контента
концовка: концовку
который: которого которое которые который которым которыми
крепость: крепости крепость крепостью
кроме: кроме
крутой: крутого крутое крутой крутых
кто: кому
курс: курсе
куча: кучей
лаборатория: лаборатории
лайк: лайк
лайфхак: лайфхаки
лаконично: лаконично
легко: легко
линия: линия
лично: лично
личный: личная
лишний: лишнее
локация: локации локациям
лор: лор
лут: лут лута
маленький: маленькие
манила: манила
март: марта
менеджмент: менеджмент менеджмента
место: местам
механик: механик
мина: мин
минимализм: минимализм
минималистичный: минималистична минималистично
минута: минут минуты
мир: мир миру
млн: млн
мнение: мнение
многие: многие
многий: многих
многопользовательский: многопользовательские
множество: множество
мобильный: мобильные
модуль: модули
мой: моих
момент: момент
мочь: могут можете
мультиплеер: мультиплеер
навредить: навредить
назад: назад
наиграть: наиграл
найти: найденные найти нашел
намного: намного
напоминать: напоминает
народ: народов
нарратив: нарратив
населить: населенные
настолько: настолько
настоящий: настоящий
насчитывать: насчитывает
находить: находим
начаться: начался
небольшой: небольшие
невиновный: невиновным
недавний: недавний
неделя: недели
недоступный: недоступны
некоторый: некоторые
ненужный: ненужное
необходимость: необходимости
необязательно: необязательно
непопулярный: непопулярное
несколько: несколько
никакой: никакой
новинка: новинки
новичок: новичкам
новость: новости
новый: новые
нужно: нужно
оба: обеих
обилие: обилия
обитель: обитель
обусловить: обусловлено
общий: общей общий
объём: объем
объёмно: объемно
обычный: обычным
обязательно: обязательно
обязать: обязан
оглавление: оглавление
ограниченность: ограниченность
ограниченный: ограниченные
огромный: огромного
один: одной одну
одиночный: одиночной одиночные одиночных
олдскульный: олдскульная олдскульной
она: неё
описывать: описывает
определённый: определенные определенных
опрос: опрос
оружие: оружия
основа: основы
основать: основана
основный: основного основных
особенность: особенностей
оставлять: оставляет
отвлечься: отвлечься
отдельный: отдельного
открытый: открытому
отличие: отличие
отомстить: отомстить
отряд: отряду
охота: охота
очень: очень
очередь: очередь
ощущение: ощущение
павлена: павлену
партийный: партийная
пауза: паузой
первый: первую первые первый первых
перекидывать: перекидывать
переключаться: переключаться
периодически: периодически
персонаж: персонажа персонажам персонажей
плохой: худших
плюс: плюс
побывать: побывает
поговорить: поговорить
подаваться: подается
подача: подача
подготовка: подготовке
подземелье: подземелий подземелье
подземный: подземным
подписаться: подписаться подпишитесь
подписка: подписки
подписчик: подписчиков
подписываться: подписывайся
подражание: подражания
подтверждение: подтверждение
пожалуй: пожалуй
познать: познал
поиграть: поиграть
пока: пока
показать: показала показать
показаться: покажется
покидать: покидают
покой: покоя
полезный: полезное
полностью: полностью
помещаться: помещается
помимо: помимо
помочь: помочь
помощь: помощь помощью
понадобиться: понадобились
понимать: понимаете
понравиться: понравилась
попасть: попали
попросить: попросит
посвятить: посвященный
поселение: поселений
посетить: посетили
последний: последнего последних
посмотреть: посмотрим
поставить: поставить
постараться: постарались
постройка: постройки
потрясать: потрясающий
почему: почему
почитать: почитать
поэтому: поэтому
практически: практически
превращать: превращает
привыкнуть: привыкшим
приключенческий: приключенческой
прикручивать: прикручивать
пример: примером
причина: причина
приятно: приятно
приятный: приятнее
проблема: проблемах
продавать: продавать
продвигаться: продвигаться
происходить: происходит происходящего
пройти: пройти прошел
прокачать: прокачать
прокачиваться: прокачиваться
пролог: пролога
пропасть: пропавшую
пропустить: пропустите пропустить
просмотр: просмотр
простенько: простенько
просто: просто
простой: проще
прохождение: прохождение прохождении прохождения
прошлое: прошлого
прошлый: прошлом
публикация: публикации
пункт: пункты
пустой: пустой
путешествие: путешествие
пытаться: пытаешься пытался
разбираться: разбираешься
развивать: развивать
различный: различные
разнообразие: разнообразие
разный: разным
разработчик: разработчиках разработчиков
рамка: рамках
рассказать: рассказать
рассказывать: рассказывал
расчёт: расчета
реакция: реакции
реализовать: реализовано
реальный: реальном
ребёнок: детям
реддит: реддит
рекомендовать: рекомендуем
религия: религий
релиз: релиза
ренессанс: ренессанс
решение: решений
ровно: ровно
ролевый: ролевые
ролик: ролики
рпг: рпг
рынок: рынке
сам: самого
самый: самое самых
свежеть: свежеть
свой: своей своих
связка: связок
сделать: сделать
сервис: сервисом
сердце: сердца
серия: серии
серьёзно: серьезно
сильно: сильно
система: система системы
ситуация: ситуаций
сказать: сказать
скайрим: скайрим
следить: следить
слишком: слишком
сложность: сложности
смерть: смертью
смысл: смысла смысле
снимать: снимает
собираться: собирались
событие: событий события
совет: советы
современность: современности
современный: современном
согласиться: соглашусь
содержаться: содержатся
создаваться: создается
сойти: сойти
сочетаться: сочетаются
спасение: спасения
спасибо: спасибо
спойлер: спойлеры
спортс: спортсе
спускаться: спускаться
сразу: сразу
стать: стала
статья: статьи
стоить: стоит
страдать: страдать
страна: стран
стратегия: стратегии
строить: строить
строиться: строилось
субъективно: субъективно
судьба: судьбу судьбы
сундук: сундук сундуку
считать: считая
сюжет: сюжет сюжета сюжетов сюжету
сюжетный: сюжетная сюжетные
тайна: тайнам
также: также
такой: таких такого
тактический: тактической
текст: тексте
тема: темой тему темы
торговец: торговцам
тот: та тех
точка: точек
травница: травница
третий: третьего
тщательный: тщательной
тыс: тыс
угроза: угрозы
удар: удар
удивляться: удивляемся
удобный: удобный
ум: ума
умеренный: умеренный
ухо: уши
фактически: фактически
хит: хитах
ход: ходу
хороший: лучшие лучших хорошем хороши
хотеться: хочется
хотя: хотя
целое: целое
целый: целые
час: часов
частично: частично
часть: частей части частях
человек: людей людям
число: числе
читать: читали читать
что: чему
чудесный: чудесного
шанс: шансы
шедевр: шедевр
штука: штуки
экономить: экономит
экран: экран
экшен: экшен
экшн: экшн
этаж: этажам
это: это
этот: эта
ян: яна
