аж: аж
активация: активацию
алдуин: алдуина
анимациимода: анимациимод
анимация: анимации
артефакт: артефакты
атака: атаки
атмосфера: атмосферу
база: базу
баланс: баланс
баскетбол: баскетбола
бег: беге
бедрок: бедрок
безумный: безумным безумных
бен: бен
бесить: бесят
бессмысленность: бессмысленностью
битва: битв битвы
блок: блоки
бой: бою
босс: босса
брак: брак
бросать: бросая
бывать: бывает
вакансия: вакансии
вариант: варианты
варка: варки
ваш: ваш
вводить: вводит
великий: великих величайшие
весело: весело
взаимодействие: взаимодействие
взгляд: взгляд
взглянуть: взгляните
визуальный: визуальную
вместо: вместо
внешность: внешность
вода: вода воду
водупочему: водупочему
возможность: возможности
волейбол: волейбола
волшебный: волшебные
вообще: вообще
враг: враг врагов
вредный: вредна
время: время
встречаться: встречаются
вступать: вступать
выглядеть: выглядят
выпускать: выпускать
геймер: геймерами
геймплей: геймплей геймплея
герой: героев
гигантский: гигантских
глупость: глупостью
глупый: глупых
год: года
голый: голы
горизонт: горизонты
городемода: городемод
график: графику
грибной: грибные
давать: давайте
давний: давняя
движение: движения
движок: движке
декоративный: декоративные
делать: делает делая
дело: деле
деревенский: деревенских
десять: десять
дзен: дзен
дзеневакансиидзен: дзеневакансиидзен
дичь: дичь
днк: днк
добавлять: добавляет добавляют
довакино: довакином
документ: документы
дополнение: дополнения
дополнительный: дополнительные
драка: драку
дракон: драконов
древний: древнего древнем
другой: другая другими других другую
дружба: дружбу
думать: думаешь
естественно: естественно
ещёхороший: ещёлучшие
ждать: ждёт
житель: жителей
забивать: забивая
забыть: забудь
заводить: заводить
заездить: заезженное
заменить: заменив
заменять: заменяя
заставлять: заставляет
застать: застал
знак: знаков
значительно: значительно
зодиак: зодиака
игра: игр игра игру игры
играть: играли
игровой: игровой игровые игровым
игрок: игрокам игроков
игруобычно: игруобычно
игрыроссийский: игрыроссийские
игрыэкшн: игрыэкшн
идеальный: идеальный
изменить: изменят
измерение: измерении
изображение: изображения
индустрииигра: индустрииигры
инопланетный: инопланетных
инструмент: инструментом
интересуютсяследить: интересуютсяследить
интерьер: интерьеры
использовать: использовать
исследование: исследований
исследовать: исследуйте
каждый: каждого
канал: канал
квест: квесты
киберспортодиночный: киберспортодиночные
кипячёный: кипяченая кипяченую
китсуна: китсуне
клуб: клубах
кнопка: кнопку
комплектующиешутерымногопользовательский: комплектующиешутерымногопользовательские
компьютерный: компьютерных
консолинайти: консолинайти
контакт: контакты
контентпомочь: контентпомогите
который: которая которые который которым
красивый: красивые красивый
креатив: креативом
креативный: креативные
кто: кого кому
лайк: лайк
ландшафт: ландшафт
легендарный: легендарные
лес: леса
летать: летать
линия: линии
лишь: лишь
локация: локации
ломать: ломает
любить: любит
любой: любой любом
магазин: магазины
майнкрафт: майнкрафт
макароны: макарон
манекен: манекен
масса: массу
масштабный: масштабные
матч: матчи
менять: менять
месяц: месяца
метать: метать
миноглавлениеособенность: миноглавлениеособенности
минутыиграть: минутыиграть
мир: мир мире
мифический: мифические мифическими мифических
мишень: мишень
млн: млн
многий: многих
мод: модов
мода: мод модах моды
модовдлить: модовдля
молчать: молчат
монстрымода: монстрымод
мочь: могут
мощный: мощного мощных
мультиплеер: мультиплеер
мы: нами
мяч: мяч мячи
мячикмода: мячикмод
найти: найти
например: например
нарезной: нарезной
настолько: настолько
настоящий: настоящие
невероятный: невероятной
новый: новая нового новые новых
обеспечить: обеспечат
обладать: обладают
обманчивый: обманчива
обожать: обожают
огненный: огненные огненный
однако: однако
омнитрикс: омнитрикс
опция: опций
опыт: опыт
организовать: организовать
оригинал: оригинал
оружие: оружия
оседлать: оседлайте
осмыслить: осмысленный
основной: основной
особенность: особенности
оставить: оставим
осторожный: осторожным
остров: острова
открывать: открывайте открывают открывая
отлично: отлично
отношение: отношения
отображать: отображает
отчасти: отчасти
оценить: оценить
парить: парящие
паровозик: паровозик паровозика
пе: пе
первый: первый
передавать: передавая
перелопачивать: перелопачивает
персонаж: персонажа персонажей
питие: питья
плавание: плавании
плавный: плавными
повышать: повышают
подготовка: подготовки
подписываться: подписывайся
подробный: подробнее
позволять: позволяет
показаться: показаться
покой: покое
полезный: полезна
полностью: полностью
полный: полной
получить: полученный
помогать: помогает
помочь: помогут
помощь: помощью
понравиться: понравившемуся
поражать: поражают
портал: портал портала
посмотреть: посмотрим
поставить: поставить поставь
постараться: постараемся
появляться: появляется
превращаться: превращаться
предложить: предложат
предстоять: предстоит
преображать: преображают
преобразоваться: преобразуйтесь
привлечь: привлек
придумывать: придумывать
приключение: приключения
прилетать: прилетает
принять: приняты
приручить: приручите
провести: провести
продавать: продающие
пропустить: пропустите пропустить
прямо: прямо
публикациина: публикациине
работать: работают
развивать: развивать
разместить: размещён
разный: разную
разрешение: разрешении
разрушать: разрушать
рассказать: расскажем
расширять: расширяют
реалистичный: реалистичной реалистичные реалистичными
ребёнок: детей
ролевый: ролевые
сам: самом
самостоятельный: самостоятельные
самый: самых
свой: своей своем своим
сделать: сделали
себя: собой
сегодня: сегодня
сегодняузнать: сегодняузнайте
семья: семьи семью
семьямода: семьямод
сила: силой
симулятор: симуляторы
слабый: слабых
сливать: сливать
сложность: сложность
смотреть: смотришь
смочь: сможете
собирать: собирайте
совершенно: совершенно
совместимый: совместим
содержать: содержат
создавать: создавать создавая
создатель: создатели
создать: создать
составлять: составляющую
социальный: социальные
спешить: спешите
список: списка
спортивный: спортивные
способность: способностями
сражаться: сражаются
сражение: сражений сражения
сразиться: сразитесь
стандартный: стандартные стандартных
стать: стать
стильный: стильные
стихия: стихий
стоить: стоит
стратегия: стратегии
строить: строить
суккуб: суккубом
суть: сути
существамода: существамод
существенно: существенно
существо: существ существа существами
существование: существованием
сыграть: сыграть
сюжетный: сюжетные
такой: такие такими такое
творчество: творчества
текстура: текстурами
телепузик: телепузики
тема: темы
темувидеостатьироликиновостивидеоигрыдетямвсё: темувидеостатьироликиновостивидеоигрыдетямвсё
темувойтиглавнаяподпискинайти: темувойтиглавнаяподпискинайти
темуновинка: темуновинки
темыгеймингигровый: темыгеймингигровые
тестировать: тестировать
томас: томас томаса
топамишень: топамишень
топамода: топамоды
тот: тех
традиция: традиция
требовать: требующие
трио: трио
увлекательный: увлекательные увлекательный
угар: угара
удача: удача
удерживать: удерживая
удобный: удобным
улучшать: улучшает улучшают улучшая
уникальный: уникальными уникальных
упад: упаду
урон: урон
уронабен: уронабен
уронамода: уронамод
фаербол: фаерболы
фана: фана
фасадмода: фасадмод
физика: физики
футбол: футбола
хлеб: хлеб
хлебо: хлебо
ходьба: ходьбе
хороший: хорошей
хотеться: хочется
хохотать: хохотать
храм: храм
целый: целые
цель: цели
часть: частью
человек: человек
читать: читали
что: чём
чудовище: чудовищами
чушь: чушью
шар: шары
шармода: шармод
шокировать: шокируют
шрека: шрека
экстерьер: экстерьеры
элемент: элементы
эпический: эпические
эпичный: эпичных
это: это
