аксессуар: аксессуары
актёр: актёр
александер: александера
ассистент: ассистентом
атмосфера: атмосфера
бороться: борются
будущее: будущем
быть: буду
вакансия: вакансии
ваш: ваш ваши
версия: версии
взглянуть: взгляните
взять: возьмёт
видео: видео
видеоигра: видеоигры
видеть: видят
войти: войдёт войти
вообще: вообще
воссоединение: воссоединении
временно: временно
вскоре: вскоре
встретиться: встретиться
всё: всё
второе: второе
высказаться: высказалась
высокий: высоким
выступать: выступать
выше: выше
гейминг: гейминг
гилмор: гилмор
главный: главная
говорить: говорил
год: года году
девочка: девочки
делать: делает делать
день: день дня
джаред: джаред
дженсено: дженсеном
дзен: дзен дзене
дойти: дойдёт
документ: документы
достаться: достанется
друг: друг другом
ещё: ещё
желать: желаем
занять: займет займёт занял
заявление: заявлением
знать: знаю
игра: игры
игровой: игровой игровые
игрок: игрока игроков игроком
издание: изданию
индустрия: индустрии
интервью: интервью
интересоваться: интересуются
информация: информация
исаев: исаев
исполнять: исполнял
источник: источника
канал: канал
карьера: карьеру
киберспорт: киберспорт
киберспортивный: киберспортивная
клуб: клуба
коллектив: коллектив коллектива
коллера: коллеры
команда: команда команде команды
комментарий: комментарии комментарий
комментировать: комментировать
комплектующие: комплектующие
конец: конец концу
консоль: консоли
контакт: контакты
который: который
легкомысленно: легкомысленно
личный: личным
май: мая
марк: марк
март: марта
место: место
месяц: месяца
мина: мин
минута: минута минуты
мир: миру
млн: млн
многий: многих
многопользовательский: многопользовательские
мобильный: мобильные
мозг: мозги
наверняка: наверняка
надеяться: надеемся
назад: назад
найти: найти
написать: напишите
наставник: наставника
наш: нашим
неделя: неделю
неизвестно: неизвестно
немного: немного
нервничать: нервничает
несколько: несколько
новинка: новинки
новость: новости
новый: нового новые новым
облажаться: облажается
общий: общем
обязанность: обязанности
одиночный: одиночные
около: около
организация: организация
орфография: орфографии
отобраться: отобралась
очень: очень
падалёкий: падалеки
пацан: пацанах пацанов
первый: первого первое первым
подписаться: подписаться подпишитесь
подписка: подписки
подписчик: подписчиков
пока: пока
покинуть: покинул
понравиться: понравились
пост: пост поста
поставить: поставит
почитать: почитать
появиться: появилась появился
практически: практически
предикт: предикты
представить: представила
приключение: приключения
принять: приняли
продолжить: продолжит
прокомментировать: прокомментировала
прописать: прописать
пропустить: пропустите пропустить
просто: просто
прощальный: прощальный
публикация: публикации
публиковаться: публикуется
пугать: пугает
пунктуация: пунктуации
пытаться: пытаются
пятый: пятом
рассказать: рассказал
расставаться: расстаемся
ребёнок: детям
рейтинг: рейтинге
рекомендовать: рекомендуем
решение: решение
решиться: решится
ролевый: ролевые
ролик: ролики
роль: роли
российский: российские
себастьян: себастьян
сегодня: сегодня
сезон: сезоне
сервер: сервере
сеть: сетях
сильный: сильнее сильные
сказать: сказал
скиллом: скиллом
следить: следить
смелый: смелые
собираться: собираемся
создавать: создавать
сообщить: сообщила
состав: состав состава составе
сохранение: сохранением
социальный: социальных
спорт: спорт
среднее: среднего
старт: старта
стать: стал станет
статья: статьи
столкнуться: столкнёмся
стратегия: стратегии
съёмка: съёмок
сыграть: сыграл
такой: такого
танк: танков
тема: темой тему темы
тихо: тихо
топ: топ
тот: тех
тренер: тренера тренером
тренировка: тренировок
третий: третье
тройка: тройку
трудный: трудное
турнир: турнирах
тыс: тыс
тяж: тяжа
ужасно: ужасно
уокер: уокер
уход: уход
участник: участник
финал: финал финалов
хороший: лучших наилучшего хороший
хух: хух
человек: люди
шиманчик: шиманчик шиманчика
шутеры: шутеры
эклз: эклзом
экшн: экшн
это: этим это
