аккуратно: аккуратно
аксессуар: аксессуары
армия: армии
брать: беру
бронь: броней
буквально: буквально
бумага: бумагой бумагу
бумажный: бумажного
быть: будут
вакансия: вакансии
весь: всем
ветчина: ветчиной ветчину ветчины
взаимодействие: взаимодействие
взбить: взбейте
взглянуть: взгляните
взрыв: взрыва
видео: видео
видеоигра: видеоигры
вкус: вкуса
вкуспобеда: вкуспобеды
влиять: влияют
воздушность: воздушности
войти: войти
ворваться: ворвавшись
вселенная: вселенная вселенной вселенных
вспомогательный: вспомогательных
всё: всё
выживальщик: выживальщика
выложить: выложите
выпечка: выпечки
выпить: выпив
выпустить: выпустить
вырваться: вырвалась
вытечь: вытекла
выше: выше
геймерскаякухня: геймерскаякухня
гейминг: гейминг
генерал: генералов
главный: главная
голландский: голландский голландским
голодный: голодный
готовимсдуша: готовимсдушой
готовить: готовить
готовность: готовности
гриб: грибы
грибной: грибной
дань: дань
дать: дайте
день: дня
деревенский: деревенский
деталь: деталей детали
дзен: дзен дзене
добавить: добавьте
документ: документы
достать: достаньте
другой: других
духовка: духовку
еда: еда
едадлявыживальщик: едадлявыживальщиков
ещё: ещё
ждать: ждут
жидкость: жидкость
жирный: жирных
завернутыйомлет: завернутыйомлет
завернуть: завернутый
запекать: запекайте
заставлять: заставляя
застелить: застелите
зелень: зеленью
зелёный: зеленого зеленый
зима: зимы
знакомый: знакомых
игра: игр играм игры
игровой: игровой игровые
игровыерецепт: игровыерецепты
излюбить: излюбленным
имперский: имперский имперской
ингредиент: ингредиенты
индустрия: индустрии
интересоваться: интересуются
история: истории
йогурт: йогурт йогурта
каждый: каждый
какой: какие
канал: канал
квест: квесты
киберспорт: киберспорт
классический: классических
когтисмерть: когтисмерти
комнатный: комнатной
комплектующие: комплектующие
компьютерный: компьютерных
консоль: консоли
контакт: контакты
копчёный: копченой
который: которые
крыша: крыши
кулинарияизигра: кулинарияизигр
кулинарныеприключение: кулинарныеприключения
кухня: кухни
л: л
лайфхак: лайфхаки
лишний: лишнюю
ломтик: ломтиками
лук: лук
лука: лука
любимый: любимой
майонез: майонез майонеза
мелко: мелко
мера: мере
месяц: месяца месяцев
мина: мин
минимум: минимум
минута: минут минута
миска: миске
млн: млн
многий: многими
многопользовательский: многопользовательские
мобильный: мобильные
монитор: мониторов
морковь: моркови морковь
мука: муки муку
мы: нами
мёд: мед меда
набирать: набирают
назад: назад
найти: найти
напиток: напитки
нарезать: нарежьте нарезанного нарезанной нарезанных
насыщенный: насыщенного
натуральный: натурального
незабываемый: незабываемых
новинка: новинки
новость: новости
новый: новые новым
ностальгический: ностальгический
обернуть: оберните
оглавление: оглавление
огромный: огромное
один: одной
одиночный: одиночные
омлет: омлет омлета
омлетизигра: омлетизигры
определённый: определенные
оригинальный: оригинальный
оружие: оружие
остыть: остывший остыть
отдавать: отдает
отдельный: отдельную
отделять: отделяя
отличный: отличная
отсылка: отсылки
паприка: паприки паприку
пара: пара
пасхалка: пасхалки
пасхалок: пасхалок
первый: первых
перелить: перелейте
перемешать: перемешайте
перестать: перестану
персонаж: персонажа персонажами
пища: пищей
пищевой: пищевой
плёнка: пленкой пленку
повторять: повторять
подавать: подавайте
подготовка: подготовка
подписаться: подписаться подпишитесь
подписка: подписки
подписчик: подписчиков
подписываться: подписывайтесь
подразделение: подразделений
поиск: поисках
показать: показать
полотенце: полотенца
получаться: получается
получить: получите
помощь: помощью
порция: порции порций
поскупиться: поскупились
последний: последние
последствие: последствия
постапокалиптическаякухня: постапокалиптическаякухня
постепенно: постепенно
почитать: почитать
предел: пределы
привет: привет
приготовление: приготовление
прийти: пришел
приключение: приключения
прилипнуть: прилипнуть
примерно: примерно
приставка: приставок
причём: причем
продукт: продуктом
прокачка: прокачки
пропустить: пропустите пропустить
простой: простых
противень: противень
публикация: публикации
пустошнаяед: пустошнаяеда
радиоактивный: радиоактивные
размер: размером
разнообразие: разнообразие разнообразия
разогреть: разогрейте
распитие: распития
рассказать: рассказать
расчёт: расчет
ребёнок: детям
регион: регионов
рекомендовать: рекомендуем
ретрогеймер: ретрогеймер
рецепт: рецепт рецепта рецепты
рецептыдлягеймер: рецептыдлягеймеров
рецептыизпустошь: рецептыизпустоши
решить: решил
рисовый: рисового рисовый
ролевый: ролевые
ролик: ролики
российский: российские
рулет: рулет
салат: салат салата
сборка: сборка
свежеть: свежей
свой: свое
сериал: сериал сериале сериалом
серия: серии серия
система: система
сказать: сказать
скрутить: скрутите
скручивание: скручивания
следить: следить
сливка: сливки сливок
сливочный: сливочного сливочный
словно: словно
слон: слон
смесь: смесь
смешать: смешайте
смотреть: см
совет: совет
создатель: создатели
солдат: солдат
соломка: соломкой
соль: соли соль
соус: соус соусом
средний: средний
ст: ст
стакан: стакан стакана
стать: стало станет
статья: статьи статью
стол: столе
стратегия: стратегии
сушёный: сушеного сушеный
сыр: сыр сыра
также: также
телевизор: телевизоров
тема: темой тему темы
температура: температуры
трава: травами
убрать: уберите
уважение: уважения
удалить: удалите
удалённый: удаленных
узнать: узнайте
уксус: уксус уксуса
употребление: употребления
уровень: уровень
усеять: усеяли
условие: условиях
ученик: ученик
фанат: фанатов
франшиза: франшизе
холодильник: холодильник холодильника
хоркер: хоркера
хороший: лучшей
целый: целые
ч: ч
час: час
частность: частности
часть: части частях
человек: людей
читать: читали
шедевр: шедевром
ширина: шириной
шоу: шоу
шутеры: шутеры
щепотка: щепотку
экран: экранам экраны
эксклюзивный: эксклюзивные
экшн: экшн
эпизод: эпизод
эффект: эффекты
яблоко: яблок яблоко
являться: является
ядерный: ядерного ядерной
яйцо: яиц яйца
