анонсировать: анонсировала
архитектура: архитектурой
аудиосистема: аудиосистемы
база: базе
битва: битву
благодаря: благодаря
бюджетный: бюджетных
вакансия: вакансии
версия: версии версию
весы: весы
весь: вся
взглянуть: взглянем взгляните
видео: видео
видеоигра: видеоигры
видеокарта: видеокарта видеокартой видеокарту видеокарты
видеопамять: видеопамяти
видеоускоритель: видеоускорителя
вильяновый: вильянова
войти: войти
всё: всё
выбирать: выбирать
выбор: выбору
выпуск: выпуска
выходить: выходит
гаджет: гаджеты
гб: гб
гейминг: гейминг
геймплей: геймплей
главный: главная
говорить: говорить
год: год года
горячий: горячую
готовый: готовы
грабли: граблям
графика: графикой
графический: графические графическим графических графического графическую
гц: гц
давать: давайте
данный: данный
два: две
действительно: действительно
день: дня днях
дзен: дзен дзене
добавлять: добавляют
документ: документ документе документы
дорого: дорого
доступный: доступной
ещё: ещё
её: её
ждать: ждать
железо: железа
жизнь: жизнь
задача: задачи
записать: записал
запретить: запретить
зафиксировать: зафиксированы
заявить: заявленной
игра: игр
игровой: игровые
известно: известно
известный: известный
изрядно: изрядно
иметь: имеет
инсайдер: инсайдер
интеллект: интеллект
интересный: интересного
интересоваться: интересуются
интонация: интонации
информация: информации информация
искусственный: искусственный
источник: источник
камера: камеры
канал: канал
карман: кармана
карта: карт карту
колонка: колонки
компания: компании
консоль: консоли
контакт: контакты
который: который
крым: крыму
кто: кого
курск: курск
лечь: ляжет
линейка: линейке
лихорадка: лихорадки
личный: личный
любой: любые
майнинговый: майнинговой
маркет: маркет
мгц: мгц
месяц: месяца
мимика: мимика
мина: мин
минута: минута минуты
мир: мире
млн: млн
мобильный: мобильные
модель: моделях
модификация: модификацией модификаций модификацию
мой: мои
монстр: монстры
мочь: могу
мощный: мощную
надзор: надзор
надёжный: надежный
назад: назад
найти: найти
накопитель: накопитель
наушник: наушники
начало: начале
неанонсировать: неанонсированной
независимый: независимая
неловко: неловко
несмотря: несмотря
ник: ником
никакой: никакой
новинка: новинка
новость: новости
новый: нового новые
ноутбук: ноутбука ноутбуки
обеспечить: обеспечить
обновить: обновлённого
обновление: обновления
он: нём
оперативный: оперативной
опечатка: опечатка
описание: описанием
оплатить: оплачено
опубликовать: опубликовал
опыт: опыт опыте
организация: организация
ослабление: ослабление
оснастить: оснащенную
основа: основу
основной: основные
остальной: остальная
осуществлять: осуществляющая
отметить: отметить
отраслевой: отраслевые
официально: официально
официальный: официальной
память: памяти
плавный: плавный
планшет: планшеты
победитель: победителем
повествование: повествованию
подписаться: подписаться подпишитесь
подписка: подписки
подписчик: подписчиков
подробность: подробности
пока: пока
поколение: поколения
получить: получит
посмотреть: посмотреть
поток: потока
почитать: почитать
поэтому: поэтому
предназначить: предназначена
представить: представила представлен представленного
представлять: представляет
привлечь: привлек
пройтись: прошлись
пропустить: пропустите пропустить
просить: прошу
против: против
процессор: процессор процессоров процессором
прощение: прощения
публикация: публикации
работа: работы
разгромить: разгромить
разный: разных
разработка: разработкой
разрешение: разрешением разрешении
ранить: ранят
раскрыть: раскрыл раскрыта
рассмотреть: рассмотрим
расшифровка: расшифровке
ребёнок: детям
регион: регионов
рейтинг: рейтинги
рекомендовать: рекомендуем рекомендую
ролик: ролик ролики
сам: самой
самый: самую
свой: своем
себя: собой
сегодня: сегодня
сергей: сергея
сеть: сети
сказать: сказанное
следить: следить
смартфон: смартфоны
снова: снова
собственный: собственного
событие: события
совет: советы
современный: современные
согласно: согласно
сообщить: сообщил
соответствовать: соответствует
составить: составит
социальный: социальной
способный: способна
сравнение: сравнение
срок: сроках
стандарт: стандарт стандартов
стать: стало
статья: статьи
стоимость: стоимость
стоить: стоит
стоять: стоят
строго: строго
также: также
такой: такое
тактовый: тактовую
тб: тб
тезис: тезисы
тема: темой тему темы
технический: технические
технодзен: технодзен
технологический: технологических
технология: технологии
топовый: топового топовой топовую
торговый: торговая
трекер: трекеры
тыс: тыс
узнать: узнаем
умный: умные
уникальный: уникальная
упоминание: упоминание
утечка: утечке
уточняться: уточняется
финальный: финальную
фитнес: фитнес
фототехник: фототехника
характеристика: характеристиках характеристики
цена: ценой
частота: частотой частоту
часы: часы
читать: читали
щедро: щедро
электроника: электроника
яндекс: яндекс
