апдейт: апдейт
бесплатно: бесплатно
вакансия: вакансии
ваш: ваш вашим
верить: верил
версия: версия
вершинный: вершинного
весь: всем вся
взглянуть: взгляните
видеокарта: видеокарт видеокарта
видеть: видеть
вместе: вместе
возможность: возможностям
ворох: вороху
вредить: вредит
время: времени
всякий: всяких
выйти: вышла
выше: выше
гб: гб
геометрия: геометрию
глобальный: глобального
год: год года
господин: господа
давать: давайте
давно: давно
далее: далее
делать: делает
демоверсия: демоверсии
день: дня
дзен: дзен
дзеневакансиидзен: дзеневакансиидзен
динамический: динамических
добрый: доброго
документ: документы
дорогой: дорогие
достаться: досталась
доступный: доступна
друг: друзья
другой: другое
естественно: естественно
железный: железный
запуск: запуска
затенение: затенений затенения
игра: игр игра играх игру игры
игровой: игровой
интересный: интересная
интересуютсяследить: интересуютсяследить
кадр: кадров
канал: канал
карта: карт
картинка: картинку
качество: качестве
команда: команда
комментарий: комментарий
комментироватьпока: комментироватьпока
контакт: контакты
который: который
линейка: линейкой
лично: лично
личный: личных
луч: лучей
магазин: магазине
магический: магическая
маркет: маркет
масштабный: масштабный
материнский: материнские материнских
месяц: месяца
минимум: минимум
минобновить: минобновленная
минутрейтинг: минутрейтинги
млн: млн
моддёр: моддеров
модель: модели
мой: моём
мол: мол
мочь: мог могут
мы: нам
навроде: навроде
назадподписатьсятоп: назадподписатьсятоп
назадподписатьсятрассировка: назадподписатьсятрассировка
найти: найти
наличие: наличию
наступить: наступил
наткнуться: наткнулся
начало: начале
начать: начали
начинать: начинаем
новость: новость
новый: новые новый новых
ноябрь: ноября
нужный: нужна
обновить: обновленного
объект: объектов
один: одна
оперативный: оперативной
опробовать: опробовать
оригинальный: оригинального
освещение: освещения
особенность: особенности
отвечать: отвечала
отзыв: отзывах
отсортировать: отсортирована
очень: очень
память: памяти
первымрекомендовать: первымрекомендуем
плата: плат платы
плохой: хуже
поверить: поверить
погнать: погнали
подборка: подборка
подвал: подвал
поддержка: поддержке поддержку
подписчиковподписатьсявыйти: подписчиковподписатьсявышла
подписываться: подписывайся
покупатель: покупателей
полноценный: полноценный
получать: получать
получить: получила
пользователь: пользователи
помимо: помимо
понадобиться: понадобится
популярный: популярных
порт: портов
поэтому: поэтому
появляться: появляться
привет: привет
прийти: пришел пришла
производительность: производительность
пропустить: пропустите пропустить
просто: просто
процессор: процессор процессоров
публикациина: публикациине
пятка: пятки
рад: рад
разработка: разработку
рассказать: расскажу
результат: результаты
рейтинг: рейтинг рейтинга
релиз: релиз
ремастер: ремастером
самый: самых
сегодня: сегодня
сеть: сети
сильно: сильно
смена: смену
снижать: снижает
современный: современных
сокет: сокете
соотношение: соотношения
составить: составить
составление: составлении
состояться: состоится
способ: способ
сравнительно: сравнительно
ссылка: ссылка
статический: статических
стать: стала станет
стоимость: стоимости
тайтлый: тайтла
такой: такие
тема: темой
темувидеостатьироликиновостивидеоигрыдетямвсё: темувидеостатьироликиновостивидеоигрыдетямвсё
темувойтиглавнаяподпискинайти: темувойтиглавнаяподпискинайти
теневой: теневых
тест: тестов тесты
технология: технологией технологий технология
тип: типа
тихонаписать: тихонапишите
трассировка: трассировка трассировки
тыс: тыс
убывание: убыванию
удвоить: удвоили
улучшить: улучшенная улучшенную
учитывать: учитывал
фактор: факторов
формат: формате
характеристика: характеристики
хороший: лучшие
хотеться: хотелось
целый: целому
цифровой: цифровом
частота: частоту
честь: честь
чипсет: чипсета
читать: читали
это: этим это
этот: эта
юбилей: юбилея
являться: является
яндекс: яндекс
