адмиралтейство: адмиралтейство
аксессуар: аксессуары
альтернативный: альтернативная
архив: архива
атака: атаки
атлантика: атлантику
бархэма: бархэм
битва: битве
битти: битти
ближний: ближней
блог: блог
бой: бою боя
большой: большого
британец: британцам
британский: британского
быстро: быстро
быстроходный: быстроходного
вакансия: вакансии
ваш: ваш
вашингтонский: вашингтонского
век: веков
великобритания: великобританией
версия: версии
ветка: ветки
взаимодействие: взаимодействие
взглянуть: взгляните
вид: видов
видео: видео
видеоигра: видеоигры
вовсе: вовсе
война: войне войны
войти: войти
вообще: вообще
воспользоваться: воспользоваться
впервые: впервые
враг: враг
временной: временном
вспоминать: вспоминаем
всё: всё
второй: втором
вход: входа
вчера: вчера
вынудить: вынуждено
выпустить: выпустить
вэлиант: вэлиант
гарантировать: гарантирует
гейминг: гейминг
главный: главная
глубина: глубинах
год: год года лет
готовый: готова
громкий: громких
давно: давно
данный: данном
дать: дать
два: двух
действовать: действовали
держава: держав
дзен: дзен дзене
дистанция: дистанции дистанцию
довольно: довольно
договор: договор
документ: документы
доработать: доработанных доработать
дочитать: дочитайте
ещё: ещё
её: её
ждать: ждут ждёт
забытый: забытое забыты
загадочный: загадочных
заключить: заключённого
зачастую: зачастую
знакомиться: знакомиться
значительный: значительный
игра: игре игру игры
играть: играющие
игровой: игровой игровые
игрок: игрока
известный: известного
изменение: изменений изменения
индустрия: индустрии
интересоваться: интересуются
история: истории историй история
итак: итак
италия: италией
итог: итог
канал: канал
кардинально: кардинально
киберспорт: киберспорт
класс: класса
км: км
кой: кое
количество: количества
колон: колоне
комментарий: комментарии комментарий
комментировать: комментировать
комплектующие: комплектующие
комфортный: комфортным
конец: конца
консоль: консоли
консульство: консульства
контакт: контакты
концепция: концепция
корабль: кораблей корабли кораблю корабля
который: которое
крайне: крайне
крейсер: крейсер крейсера
крупный: крупные
крыло: крыла
куин: куин
либо: либо
линейный: линейные линейных
линкор: линкоры
лодка: лодки лодок
лондонский: лондонское
малайя: малайя
масса: массу
менее: менее
месяц: месяцев
механик: механик
механика: механики
мина: мин
минувший: минувших
минута: минут
мир: мир
мировой: мирового мировых
млн: млн
многопользовательский: многопользовательские
мобильный: мобильные
момент: момент
морской: морского
мочь: могут
назад: назад
найти: найти
нанести: нанесет нанести нанеся
наносить: наносит
написать: напишите
находиться: находятся
начало: начало началом
начинаться: начинается
неважно: неважно
негативный: негативных
некоторый: некоторые
немало: немало
немой: нем
неотъемлемый: неотъемлемой
несколько: несколько
новинка: новинки
новость: новости
новый: новое новые новых
обнаружить: обнаруженной
оглушительный: оглушительных
огонь: огня огонь
один: одной
одиночный: одиночные
однобокий: однобоким
оказываться: оказывается
океан: океана
они: ними
опасный: опасна
опыт: опытом
оружие: оружие оружия
особенный: особенное
особый: особых
оставить: оставили
оставлять: оставляет
отдельный: отдельном
открыть: открыли
отметить: отмечено
панамский: панамский
первый: первой первом первым
пл: пл
победа: побед
повторять: повторяю
подводный: подводного подводном подводные подводный подводных
поддержать: поддержав
подкрепление: подкрепление
подлодка: подлодка подлодке подлодки подлодок
подойти: подошло
подписаться: подписаться подпишитесь
подписка: подписки
подписчик: подписчиков
подряд: подряд
пока: пока
поле: поле
получаться: получается
пометка: пометкой
поражение: поражений
постоянно: постоянно
поступить: поступила
почитать: почитать
превосходство: превосходство
предать: преданные
предполагать: предполагаемых
преимущество: преимущество
премиум: премиум
прибыть: прибыл
прийтись: пришлось
приключение: приключения
применение: применений
применить: применил
примерно: примерно
провести: проведенных
продолжать: продолжаем
пройти: пройдет
прокачивать: прокачиваемые
пропустить: пропустите пропустить
протестировать: протестируют
противник: противнику
процесс: процесс
прочитать: прочитать
публикация: публикации
пять: пяти
разный: разными
разработать: разработал
разработчик: разработчики разработчиков
ранее: ранее
расположить: расположенном
ребёнок: детям
рекомендовать: рекомендуем
республика: республики
решать: решала
решающий: решающее решающим
ролевый: ролевые
ролик: ролики
российский: российские
рубеж: рубеже
ряд: ряд
сам: сама самих
самый: самых
свой: свои
сделать: сделать
секретно: секретно
систершип: систершипа
скопировать: скопировать
скрытый: скрытых
следить: следить
случай: случае случаев
смочь: смог
событие: событие
совершать: совершает
совершенно: совершенно
советник: советника
соглашение: соглашения
сократить: сократили
состав: составе
список: списком
сражение: сражения
срочный: срочная
становиться: становилось становится
стать: стали стало станет
статья: статьи статью
сто: ста
столкновение: столкновение
столкнуться: столкнувшегося
стратегия: стратегии
субмарина: субмарина
существовать: существует
сфокусировать: сфокусированного
сша: сша
сюркуф: сюркуф
тайна: тайна
также: также
такой: таких таком
тактика: тактик тактика
таранный: таранная
телеграмма: телеграмма
тема: темой тему темы
тестирование: тестирования
технология: технологиях
тип: типа типе
тихо: тихо
торпеда: торпеды
третий: третьей
тыс: тыс
тысяча: тысяч
уничтожение: уничтожение
уничтожить: уничтожена уничтожит
уорспайта: уорспайт
упор: упор
урон: урон урона
успешный: успешные
ухудшить: ухудшив
фактор: фактором
фанат: фанаты
февраль: феврале февраля
франция: францией
французский: французский
хипперо: хиппера
хотеть: хотят
хотя: хотя
целый: целый
цель: целью
часто: часто
часть: части частью
читать: читали
шутеры: шутеры
экшн: экшн
элизабет: элизабет
эмоция: эмоций
эскадра: эскадры
это: этим это
этот: эта
ютландский: ютландском
япония: японией
