автомобиль: автомобили
аж: аж
аккаунт: аккаунт
аксессуар: аксессуары
активировать: активируете
алгоритм: алгоритм
аналог: аналог
ах: ах
баланс: баланс
библиотека: библиотеке
битва: битва
боль: боли
больший: большее
бот: бота
бросаться: бросаться
бубен: бубном
будущее: будущее
быстро: быстро
быть: будем
вакансия: вакансии
вариант: варианты
ваш: ваши
вводить: вводите
вдобавок: вдобавок
вдуматься: вдумайтесь
вернуться: вернуться
версия: версию версия
весь: весь
взглянуть: взгляните
видео: видео
видеоигра: видеоигры
визуал: визуал
включить: включить
вместе: вместе
внимание: внимание
вновь: вновь
возвращаться: возвращаться
возможно: возможно
возможность: возможности возможность
возникнуть: возникнут
войти: войти
вопрос: вопросы
вполне: вполне
время: времена время
вспомнить: вспомнить
всякий: всяких
всё: всё
вы: вами
выбирать: выбираете
выбрать: выбрать
выгодно: выгодно
вызывать: вызывают
выйти: вышла
выпустить: выпустили
выручка: выручку
выход: выхода выходом
гейминг: гейминг
геймплей: геймплей
геймплейный: геймплейные
гибкий: гибким
главный: главная главные главный
глаз: глаза
говориться: говорится
год: год года году лет
головной: головной
гость: гости
готовый: готовых
граница: границей границу
графика: графике графики
громкий: громкими
гта: гта
давать: давайте
давно: давно
далее: далее
дальность: дальность
дата: дата
действие: действий
действительно: действительно
дело: делом
день: день дня
деньга: деньги
десять: десяти
детализированный: детализированнее
дешёвый: дешевле
дзен: дзен дзене
диск: дисков
добрый: добрый
дождаться: дождаться
документ: документы
достоинство: достоинства
друг: друзей друзья
другой: другого
естественно: естественно
естественный: естественнее
ещё: ещё
ждать: ждем ждет
живой: живым
жить: живет
заветный: заветную
загвоздка: загвоздка
заглядывать: заглядывайте
загрузка: загрузки
зайти: зайти
закинуть: закинуть
заключаться: заключаются
заморочка: заморочек
занять: займет
заодно: заодно
запрос: запрос
зарубежный: зарубежной
заслужить: заслуженную
игра: игр игра игре игрой игру игры
играть: играли играть
игровой: игровой игровые игровых
идти: идет
изменение: изменений изменения
измениться: изменилась
изначально: изначально
изображение: изображения
именно: именно
индустрия: индустрии
иностранный: иностранной
интересоваться: интересуются
информативный: информативным
история: истории
итог: итоги
итоговый: итоговая
казаться: казалось
какой: какие каких
календарь: календаре
канал: канал
кануть: канули
карта: картами картой карты
картинка: картинка
касаться: касается касаются
киберспорт: киберспорт
клик: кликов
кнопка: кнопку
количество: количество
команда: команда
комиссия: комиссию
компакт: компакт
компания: компании
комплектующие: комплектующие
консоль: консолей консоли консолях
контакт: контакты
контент: контент контенту
контрастный: контрастный
который: которая которые которых
кошелёк: кошелька
кратко: кратко
культовый: культовой
купить: купить
лайк: лайк
лвл: лвл
легендарный: легендарное
лишний: лишних
лос: лос
луч: лучей
лучик: лучики
любимый: любимым
лёт: лету
маркетплейс: маркетплейсы
масса: массу
меню: меню
мина: мин
минимальный: минимальное
минута: минут
мир: мир
млн: млн
многопользовательский: многопользовательские
мобильный: мобильные
монитор: мониторы
монстр: монстром
мочь: могут
мудерность: мудерности
мы: нам
мышь: мыши
набирать: набирала
наверное: наверное
награда: награды
надеяться: надеемся
нажимать: нажимаете
назад: назад
название: название
найти: найти
найтись: найдутся
наличие: наличие
написать: написать
напомнить: напомним
например: например
насыщенный: насыщен насыщенный
начаться: началась
наш: наш наша наше нашей
недавно: недавно
неделя: недели
некоторый: некоторые
некстегенов: некстегеновой
несколько: несколько
нетерпение: нетерпение нетерпением
нечто: нечто
никакой: никаких
новинка: новинки
новость: новости
новый: новая нового новой новые новый новым
ностальгировать: ностальгировать
нужно: нужно
нынче: нынче
нюанс: нюансы
обзавестись: обзавестись
обнова: обнова
обновить: обновленная обновленной обновленную
оборот: обороты
образ: образом
обратить: обратите
обращать: обращаете
обход: обхода
общий: общем
обычно: обычно
оглавление: оглавление
одиночный: одиночном одиночные
однако: однако
ожидать: ожидаемыми ожидаемых ожидает
около: около
опасение: опасения
описание: описание
оплата: оплаты
оплачивать: оплачивая
определённо: определенно
опрос: опрос
освещение: освещение
особенно: особенно
отзыв: отзывы
откладывать: откладывайте
открывать: открываете
отпустить: отпустить
отражение: отражения
официально: официально
официальный: официальном
оценить: оценить
ощутимый: ощутимая
ощущаться: ощущаться
пара: пара
пенсия: пенсию
первый: первым
пережить: пережила
переиздание: переиздание
переплата: переплат
пк: пк
план: плане
планировать: планируют
планироваться: планировалось
поведать: поведаем
поверить: поверить
повод: поводом
поддерживать: поддерживать
поддержка: поддержка
подписаться: подписаться подпишитесь
подписка: подписки
подписчик: подписчика
подробность: подробности
подтверждать: подтверждаете
подъехать: подъехали
позволять: позволяют
поздравлять: поздравляем
познакомиться: познакомиться
поиграть: поиграем
поиск: поиск
показать: показать
поколение: поколений
покопаться: покопаться
покупать: покупать
покупка: покупке покупки покупку
полностью: полностью
полный: полным
получать: получаете
получиться: получилось
помочь: помогите помогут
помощь: помощь
понравиться: понравившемуся
пополнение: пополнения
пополнять: пополнять
попробовать: попробовать
пора: пора
посмотреть: посмотрим
поставить: поставь
почитать: почитать
почта: почту
появиться: появилась появились появился
правда: правда
предложение: предложение
предложить: предложит
предназначаться: предназначалось
представитель: представители
приближаться: приближается
привод: привод
привычный: привычные
прийти: прийти
приключение: приключения
прикольный: прикольным
примерно: примерно
приобрести: приобрести
приставка: приставки приставок
приходить: приходят
причём: причем
приятный: приятней
продавец: продавца продавцу
продукт: продуктом
проект: проекта проектов
пройти: пройдена пройти
пропустить: пропустите пропустить
прорисовка: прорисовки
просто: просто
простой: прост простое
прототип: прототипов
процесс: процесс
прочий: прочей прочие
проявить: проявить
прямиком: прямиком
публикация: публикации
путь: пути
пятёрка: пятерка
разница: разница
разработать: разработают
разработка: разработка
разрешение: разрешения
раскрыть: раскрыть
расставаться: расставаться
реалистичный: реалистичными
реально: реально
ребёнок: детям
революционный: революционных
регион: регион
режим: режиме
рейтинг: рейтинг
рекомендовать: рекомендуем
релиз: релизами релизов релизу
решение: решение
ролевый: ролевые
ролик: ролики
российский: российские российскими
россия: россии
рубль: рублей рубля
рынок: рынке
сам: само самом
самый: самое самые самых
сантос: сантос
свежий: свежих
свет: свет
свой: своей своим свой
себя: собой
сиквел: сиквел
системный: системные
ситуация: ситуация
сказать: сказать
скоро: скоро
славный: славные
следить: следить
сложность: сложностей сложности
сложный: сложных
сменить: сменить
смотреть: смотреть
совместный: совместного
создать: создано создать
солнечный: солнечный
сообщение: сообщении
сообщить: сообщили
соотношение: соотношением
соперник: соперник
сорваться: сорваться
составить: составит
социальный: социальные
способ: способ способы
сразу: сразу
ссылка: ссылку
стартовый: стартовое
старый: старый
стать: стала стали стало
статья: статье статьи
стоить: стоит
стоять: стоят
стратегия: стратегии
сумма: сумма
схема: схем
тайтлый: тайтл
также: также
такой: такие таким
танец: танцев
текстурок: текстурки
текущий: текущий
тема: темой тему темы
тень: тени
терпимо: терпимо
товар: товаров
топ: топ
трассировка: трассировка
требование: требования
трудно: трудно
тыс: тыс
увеличиться: увеличилась
увидеть: увидит
увидеться: увидимся
удаться: удалось
удивительно: удивительно
удобный: удобный
указать: указаны
указывать: указываете
улучшение: улучшения
ультраширокий: ультраширокого
утолить: утолит
учитывать: учитывать
факт: факт
февраль: феврале
феномен: феномен
фигурировать: фигурирует
финальный: финальная
франшиза: франшизы
хлопоты: хлопот
ход: ходом
хороший: лучшее лучший
хотеть: хотел хотите
хотя: хотя
целое: целом
цельный: цельным
цена: ценам цену
ценник: ценники
цифровой: цифровые цифровых
часть: части
чат: чат
человек: люди
читать: читаете читали
чёткий: четче
шагнуть: шагнуть
шутеры: шутеры
эксклюзивный: эксклюзивные
экшн: экшн
эпоха: эпоха
это: это
эх: эх
