анимационный: анимационной анимационные
анонсировать: анонсировали анонсирован
арат: арат
база: базе
байкальский: байкальской
бешеный: бешеный
битва: битвы
будущее: будущего
быть: будут будьте
вакансия: вакансии
ваш: ваш
взглянуть: взгляните
взлом: взлом
взломать: взломать
вновь: вновь
водичка: водички
война: войной
вставка: вставки
выбрать: выбрать
выдавать: выдаёт
выйти: вышедшая
выход: выход выхода
герой: героем
гигантский: гигантской
главный: главным
год: год года
горо: горо
город: город
группировка: группировок
далёкий: далёкого
данные: данных
данный: данный
действие: действие
день: день дней
дерево: деревья
дзен: дзен
дзеневакансиидзен: дзеневакансиидзен
документ: документы
долгожданный: долгожданный
дополнение: дополнении дополнения
достигнуть: достигнуто
доступ: доступ доступе
доступный: доступна
её: её
жизнь: жизни
задача: задача
заморозить: замороженные
запланировать: запланирован
захватывать: захватывающими
защитить: защитить
зло: зла
знаменитый: знаменитый
игра: игра игре игры
игрок: игроков
идеально: идеально
известный: известной
извратить: извращёнными
интересуютсяследить: интересуютсяследить
информация: информации
инь: инь
источник: источником
каждый: каждый
канал: канал
качество: качество
комментарий: комментарий
комментироватьпока: комментироватьпока
компания: компании
конец: конце
контакт: контакты
кооперативный: кооперативного
коробка: коробки
корпорация: корпорации
который: которые которых
крупный: крупного
лишить: лишены
маджим: маджима
март: марта
мартачерез: мартачерез
месяц: месяцев
миниздатель: миниздатель
мир: мире
млн: млн
многочисленный: многочисленные
момент: момент
мощный: мощные
мы: нам
мэй: мэй
назад: назад
назадподписатьсябахнуть: назадподписатьсябахнем
назадподписатьсяколонка: назадподписатьсяколонка
назадподписатьсяобзор: назадподписатьсяобзор
название: названием
найти: найти
напротив: напротив
напрячь: напряжённом
настольный: настольная настольными
находиться: находится
начинаться: начинается
несгибаемый: несгибаемым
новинка: новинка
новый: новой новые новыми
ноябрь: ноябре
обзавестись: обзавелись
обзор: обзоре
обладать: обладает
один: одного
окаянный: окаянных
окончание: окончания
оригинальный: оригинальной
освоить: освоите
основной: основной
осторожный: осторожны
ответвление: ответвлением
открыть: откроете
отменить: отменить
пара: пару
первый: первая первого первых
первымрекомендовать: первымрекомендуем
передовой: передовые
персонаж: персонажей
перун: перуна
питать: питаемыми
плохо: плохо
погнать: погнали
подписаться: подпишитесь
подписчиковподписатьсяанонсировать: подписчиковподписатьсяанонсирован
подружиться: подружитесь
подряд: подряд
подходить: подходит
поле: полем
полтора: полтора
получить: получить
попробовать: попробуем
поражать: поражает
потерянный: потерянных
почитатьоколо: почитатьоколо
прайма: прайм
представить: представлены
прийтись: придётся
приквел: приквелом
приручить: прирученными
продуманность: продуманность
проект: проектами
проклятый: проклятые
пропустить: пропустите пропустить
против: против
прошлогодний: прошлогодней
публикациина: публикациине
пустошь: пустоши
путешествие: путешествии
пытаться: пытаются
пёс: пёс
разворачиваться: разворачивается
раздирать: раздираемым
различный: различных
разобраться: разобраться
разработчик: разработчики
разумный: разумной
ранний: раннем
релиз: релиз
родина: родину
роза: роза
русама: русам
русый: русы
самый: самое
свежий: свежее свежую
свой: своими
секретный: секретной
секунда: секунд
сервер: серверы
сердце: сердце
серия: серии
сиквел: сиквеле
система: системы
скорость: скорости
следовать: следуя
снаряжение: снаряжения
создать: создадите созданные
сообщить: сообщили
соревноваться: соревноваться
состояться: состоится
способность: способностей способностями
спустя: спустя
становиться: становится
стать: став стал станет
стихия: стихиями
стопа: стопам
стремиться: стремящимися
строительный: строительные
студия: студией студия
суть: сути
такой: такими
творение: творение
темувидеостатьироликиновостивидеоигрыдетямвсё: темувидеостатьироликиновостивидеоигрыдетямвсё
темувойтиглавнаяподпискинайти: темувойтиглавнаяподпискинайти
технология: технологиями
тихонаписать: тихонапишите
третий: третий
тьма: тьмы
уникальный: уникальными
упаковка: упаковки
уровень: уровни
фракция: фракциями
хакер: хакеры
хранение: хранения
часть: части
четыре: четырёх
чёрный: чёрная
экзотический: экзотическими
это: это
являться: является
японский: японской
ящер: ящеров
