автор: автор авторов
аксессуар: аксессуары
активность: активностями
балл: балл
борт: бортом
быстро: быстро
вакансия: вакансии
вариация: вариации
вдохновиться: вдохновилось
вердикт: вердикт
вечером: вечером
взгляд: взглядом
взглянуть: взгляните
взяться: взялись
видео: видео
видеоигра: видеоигры
видно: видно
вкус: вкусу
возвращение: возвращение
война: войн
войти: войти
впечатление: впечатления впечатлениях
впечатляющий: впечатляющее
время: время
вряд: вряд
вспоминать: вспоминаем
встретить: встретили
всё: всё
вчера: вчера
вызывать: вызывает
выйти: выйдет
вынести: вынесли
выпустить: выпустивших
выход: выходом
гадать: гадает
гейминг: гейминг
геймплей: геймплея
герой: герои
глава: главы
главный: главная главных
говард: говард
год: год года
готовиться: готовится
гринд: гринду
два: двумя
декабрь: декабря
делать: делает делать
демон: демонами
день: дня
дзен: дзен дзене
дилогия: дилогии
документ: документы
долгий: долгое
долгожданный: долгожданная
долгоиграющий: долгоиграющей
дополнительный: дополнительное
достойный: достойный
доступ: доступа
доступный: доступен
другой: другие
думать: думал
ещё: ещё
её: её
жаль: жаль
журналист: журналисты
задумка: задумка
закончиться: закончится
зарубежный: зарубежной
заслуживать: заслуживают
заявить: заявили
знать: знает
зрение: зрения
игра: игра игрой игру игры
играбельный: играбельными
игровой: игровой игровые
игрок: игроков
идея: идеи
идти: идёт
известно: известно
излишний: излишне
изменение: изменений
индустрия: индустрии индустрия
интересный: интереснее
интересоваться: интересуются
исторический: исторических
история: историю история
канал: канал
канон: канона
киберспорт: киберспорт
комплектующие: комплектующие
конец: концу
консоль: консоли
консультант: консультантов
контакт: контакты
концепция: концепцией
копировать: копировал
корень: корни
который: которая которые который
критик: критиков
критика: критики
кровавый: кровавых
кстати: кстати
легендарный: легендарная
лицензия: лицензии
лишь: лишь
магия: магии
май: мая
март: марта
материал: материале
менее: менее
месяц: месяца
механика: механики
мина: мин
минута: минут минуты
миссия: миссий
миядзак: миядзаки
млн: млн
мнение: мнении мнения
многие: многие
многопользовательский: многопользовательские
мобильный: мобильные
монотонный: монотонными
мрачный: мрачное
набор: набор
набрать: набрал
надоедливый: надоедливому
назад: назад
найти: найти
наоэ: наоэ
напомнить: напомним
невнятный: невнятным
негативно: негативно
неделя: недели
некоторый: некоторые
немало: немало
несмотря: несмотря
никуда: никуда
новизна: новизну
новинка: новинка новинки
новость: новости
новый: новая новейшей новой новые новым
нравиться: нравится
обзор: обзор обзоры
один: одна одним одно
одиночный: одиночные
однако: однако
одновременно: одновременно
оригинальность: оригинальность
основа: основах основу
основатель: основателем
оставить: оставить
открыто: открыто
отнюдь: отнюдь
отойти: отошли
офф: офф
оценка: оценки
очень: очень
палач: палача
первый: первые первым первых
перенести: перенесет
переубедить: переубедит
персонаж: персонажами
побочный: побочными
повествование: повествованием
подводить: подводит
поджанр: поджанр поджанра
подойти: подошло
подписаться: подписаться подпишитесь
подписка: подписки
подписчик: подписчикам подписчиков
подчёркивать: подчёркивают
поиграть: поигравших
полгода: полгода
полный: полное
полоса: полоса
получиться: получилась получились получился
популярный: популярнейшего популярный
попытка: попытку
последний: последней последних
похвала: похвал
похвалить: похвалили
почитать: почитать
появиться: появились
представить: представила
пресса: прессы
привнести: привнести
придумать: придумал
прийтись: придётся пришлось
приквел: приквел
приключение: приключение приключения
принести: принесли
приносить: приносит
проблема: проблемы
проект: проект проекта проектах
пропустить: пропустите пропустить
протагонист: протагониста протагонистами протагонистах
прохождение: прохождение
псевдоисторический: псевдоисторический
публика: публики
публикация: публикации
пускай: пускай
пустой: пустым
равноценный: равноценными
разделение: разделение
раздражение: раздражение
раздутый: раздутый
разработка: разработку
разработчик: разработчики разработчиков
ранний: раннего
рассказать: расскажем
рассказывать: рассказываем
реакция: реакциям
ребёнок: детям
рекомендовать: рекомендуем
релиз: релиз релиза релизе релизом
рецензент: рецензенты
рок: рока
ролевый: ролевые
ролик: ролики
российский: российские
рыцарь: рыцарей
ряд: ряд
сага: саги
сам: сама
самурай: самурая
сводиться: сводится
свой: свои своими
сделать: сделана
сервис: сервиса
сериал: сериал
серия: серии серия
сеттинг: сеттинге
сеть: сети
симулятор: симуляторы
синобь: синоби
сказываться: сказывается
скептик: скептиков
сконцентрироваться: сконцентрироваться
скучный: скучным
слабый: слабая
следить: следить
случиться: случится
смелый: смелой
сми: сми
современный: современные
создавать: создавая
создать: созданного
сойтись: сошёлся
состояться: состоится
спин: спин
сравнительно: сравнительно
сразу: сразу
средневековье: средневековье
ставить: ставят
становиться: становится
старание: старания
стараться: старались
старт: стартом
стать: станет
статья: статьи
стелс: стелс
стратегия: стратегии
студия: студии
судить: судя
сюжет: сюжете сюжетом
сюжетный: сюжетную
сюрприз: сюрпризов
тайна: тайн
также: также
тема: темой тему темы
тепло: тепло
тодда: тодд
точка: точки
точно: точно
трудиться: трудились
тыс: тыс
уверить: уверены
удивить: удивили удивить
удовольствие: удовольствия
улучшить: улучшенной
унылый: унылых
успешно: успешно
фанат: фанатов
формула: формуле
хидетака: хидетака хидетакой
хит: хита хитов
хороший: лучших хороша
хотя: хотя
художник: художников
часть: частей
читать: читали
чёрный: чёрная
шведский: шведские
шутеры: шутеры
эксперт: эксперты
экшен: экшен
экшн: экшн
элемент: элементах
эмбарго: эмбарго
эпоха: эпоху
это: это
этот: эта
япония: японию
ясукэ: ясукэ
