автоматизированный: автоматизированные автоматизированных
автоматический: автоматическое
азбука: азбука
аккаунт: аккаунта аккаунты
актив: активов
активно: активно
активный: активной
анализ: анализ
баг: баги
база: базой
базовый: базовый
баннер: баннеры
беззаботно: беззаботно
битва: битвы
блог: блоги
блокировка: блокировка блокировке
бот: ботов боты
бросить: бросить
быть: будут
важно: важно
вакансия: вакансии
вариант: варианты
ваш: ваш вашего вашей вашем вашим ваших вашу
вдобавок: вдобавок
великий: великие
верить: верить
весь: всем
взглянуть: взгляните
видео: видео
видеоигра: видеоигр видеоигры
видеоролик: видеоролики
виктор: виктор
вкладывать: вкладывать
включая: включая
вкратце: вкратце
вложение: вложений
вложить: вложить
внимание: внимания
вносить: вносить
внутренний: внутренние
внутри: внутри
возможность: возможность
возможный: возможные
войти: войти
время: время
всё: всё
вы: вами
выбор: выбор
выбрать: выберите
выплата: выплату
геймер: геймеров
гейминг: гейминг
главный: главная
год: году лет
готовый: готов
давать: давайте
далее: д
дальнейший: дальнейших
далёкий: далёком
действовать: действуют
деловой: деловое
день: дня
деньга: денег деньги
десяток: десятка
десять: десяти
дзен: дзен дзене
диверсификация: диверсификация
дизайн: дизайна
добавлять: добавляя
добывание: добывание
довольный: доволен
договор: договоры
документ: документы
донат: донат
дополнение: дополнений дополнения
дополнительный: дополнительного дополнительные дополнительным
достойно: достойно
доступ: доступ
доступный: доступная доступные
доход: доход дохода доходом
другой: другие
ещё: ещё
её: её
жить: жить
заинтересованный: заинтересованных
заключение: заключение
закон: законов
зарабатывать: зарабатывать зарабатывают
заработать: заработать
защита: защите
знакомство: знакомство
игра: игр играми играх игрой игру игры
игровой: игрового игровом игровые игровым игровых
игрок: игрокам игроков
идеал: идеале
идея: идеи идей идею идея
изучить: изучите
иметь: имеет
иметься: имеющимися
инвестировать: инвестировать
инвестиция: инвестиции инвестициями инвестициях
инвестор: инвесторам
инициатива: инициативы
иной: иной
инструмент: инструмент инструментами
интеллектуальный: интеллектуальной
интересный: интересен интересны интересные
интересоваться: интересуются
использование: использование использовании
использовать: использовать используйте использую используют использующих используя
использоваться: используется
исправлять: исправляя
история: историю история
источник: источник источника источников
итог: итогу
каждый: каждого каждой
какой: какие каких
канал: канал
капитал: капитал
карман: карману
карта: карты
категория: категории
качественный: качественной качественные качественных
кирей: кирея
команда: команду
компания: компании
контакт: контакты
контент: контент
концепция: концепцию
копия: копии
который: которая которые который
краудинвестинговый: краудинвестинговая
краудфандинг: краудфандинга
крупный: крупнейшая
крыться: кроется
лицензионный: лицензионные лицензионных
личный: личных
любимый: любимым любимыми
магазин: магазин
маркетинг: маркетинг
международный: международная
месяц: месяца месяцев
метод: метод методы
меч: мечом
мечта: мечта
мечтать: мечтаем
миг: миг
мина: мин
минута: минут минуты
млн: млн
многие: многие
многий: многих
многопользовательский: многопользовательского
мод: модов
мода: моды
модификация: модификации модификаций
мой: моего моё
монетизация: монетизации монетизация
мониторинг: мониторинг
мочь: можете
навык: навыки
надёжный: надежного
назад: назад
называться: называлось
найти: найдите найти
накопительный: накопительных
например: например
нарушать: нарушать
нарушение: нарушение
насколько: насколько
наслаждаться: наслаждаться наслаждаясь
настройка: настройка
наука: наука
начать: начал
наш: нашей нашем
независимый: независимым
необходимый: необходимые
неосторожный: неосторожными
неправильный: неправильное
несколько: несколькими несколько
ниже: ниже
новость: новости
новый: новые новый
нравиться: нравится
нужно: нужно
нужный: нужен
ныне: ныне
обеспечить: обеспечит
обновление: обновления
обновлять: обновляйте
образование: образование
обратиться: обратитесь
оглавление: оглавление
огонь: огнем
один: одни одним
однако: однако
одновременно: одновременно
описание: описанию
определиться: определитесь
опубликовать: опубликовать
организовать: организовать
основа: основой
основный: основных
отказываться: отказываются
открывать: открывающие
отчисление: отчисления
оформить: оформите
оценить: оцените
очень: очень
партнёр: партнеров
пассивный: пассивного пассивный пассивным
патент: патента
патентование: патентование
патентовать: патентовать
первый: первая первое
перспективный: перспективные
плагин: плагины
платный: платные
платформа: платформ платформа платформе платформы
площадка: площадки
поддержать: поддержанных поддержать
поддерживать: поддерживают
поддержка: поддержка поддержкой
подписаться: подписаться подпишитесь
подписка: подписки
подписчик: подписчика
подход: подход
подходить: подходит
пожертвование: пожертвования
позволить: позвольте
позволять: позволяют
поиск: поиск
показать: показать
покупка: покупки
полезный: полезен полезны
получать: получать получаю
получение: получение получения
пользователь: пользователей пользователям
пользовательский: пользовательских
помнить: помнить
помогать: помогают
понимать: понимают
популярный: популярна популярную популярны популярные популярных
потенциал: потенциал
потеря: потеря
почитать: почитать
поэтому: поэтому
правда: правда правду
правило: правила
превратить: превратить
предлагать: предлагайте предлагающая
предложение: предложения
предложить: предложенные
предмет: предметы
предоставлять: предоставляет предоставляют
представление: представление
предусматривать: предусматривающие
премиум: премиум
пресловутый: пресловутый
привести: приведу
привилегия: привилегии
привлекательный: привлекательным
привлечение: привлечения
приводить: приводить
пример: примера примеров примером примеры
принимать: принимайте
принцип: принципе
припеваючи: припеваючи
приток: приток
проблема: проблема
провайдер: провайдера
проверить: проверенных
программирование: программирования
прогресс: прогресса прогрессу
продавать: продавать
продажа: продаж продажа продажи продажу
продать: проданной
продвигать: продвигайте
продвижение: продвижение продвижения
продукт: продукт
проект: проектами проектов проекты
произойти: произошло
пропустить: пропустите пропустить
прославлять: прославляют
простой: проще
протяжение: протяжении
процесс: процесс
публикация: публикации
пять: пяти
работа: работам работу
работать: работает работать работают
развитие: развитием
разделить: разделить
различный: различные
разместить: разместите
разный: разные
разрабатывать: разрабатывайте разрабатывать
разработка: разработка
разработчик: разработчикам разработчиков разработчиком
рантье: рантье
распределить: распределите
распространение: распространения
распространять: распространять
рассказать: расскажу рассказать
рассказывать: рассказываю
рассмотреть: рассмотрим
реально: реально
реальный: реальная
ребёнок: детям
регион: регионе
регистрация: регистрации регистрация
регулярно: регулярно
режим: режима
результат: результатами
реклама: реклама рекламу
рекомендовать: рекомендуем
репутация: репутации
ресурс: ресурса ресурсов
решение: решения
решить: решил
риск: риски
ролевый: ролевые
ролик: ролики
роскошь: роскошь
роспатент: роспатент
российский: российская российские российского российской
россия: россии
роялти: роялти
ругать: ругают
рыночный: рыночный
сайт: сайте сайты
сам: самого
свой: свои своё
сделать: сделать
сегодня: сегодня
сервер: сервер сервера серверов сервером
сеть: сети
симулятор: симуляторах
система: система
скин: скины
сколько: сколько
следить: следите следить
смочь: сможете
снизить: снизить
собственность: собственности
собственный: собственным
совершенно: совершенно
соглашение: соглашений
сожаление: сожалению
создание: создание создания
создать: создайте создали создать
сообщество: сообществе
социальный: социальные
спалить: спалить
специализировать: специализированные
спорный: спорный
способ: способ способов способы
средство: средства
стабильный: стабильную стабильный
стартап: стартапы
статья: статьи
страна: стране
стратегия: стратегии стратегия
стриминг: стриминга
существовать: существует существуют
существующий: существующий
счёт: счетов
так: т
такой: такие таких такое
творение: творения
тема: темой тему темы
тематический: тематические
термин: термин
тот: тех
убедиться: убедитесь
увлечение: увлечение
уникальный: уникальная уникальным
управление: управление
усилие: усилия
ускоренный: ускоренному
услуга: услуги
установить: установите
устойчивый: устойчивый
ферма: ферм фермы
финансовый: финансовыми
финансы: финансах
форум: форумы
функция: функциям
хобби: хобби
хороший: хорошим
хостинг: хостинг хостинга
хотеть: хотел
хотя: хотя
цифровой: цифровая
часто: часто
человек: люди
чисто: чисто
читать: читали
чутьё: чутье
шаг: шаги
широко: широко
эксклюзивный: эксклюзивные
элемент: элемента
это: это
этот: этими
являться: являетесь является
