абора: аборе
андеграундный: андеграундных
анонсировать: анонсировала
апрель: апреле
базироваться: базировались
бесплатный: бесплатное
билли: билли
благородный: благородного
близкий: ближайшие
боевой: боевом
боец: бойца
больший: большим
брат: братьев
бывший: бывший
вакансия: вакансии
ваш: ваш
великий: великие
весь: весь
взглянуть: взгляните
вместе: вместе
внутренний: внутренняя
внушительный: внушительным
вовсе: вовсе
возможно: возможно
востребовать: востребованных
время: времен время
вселять: вселяет
выбрать: выбрал
выглядеть: выглядит
выйти: вышел вышли
выпустить: выпустив
выход: выход выхода
герой: героев
год: год году лет
город: городов
графика: графика графикой
давать: дает
два: две двумя двух
движок: движке
двухмерный: двухмерной
делать: делала
день: дня
десятилетие: десятилетие
детство: детства
джефф: джефф джеффа
джимми: джимми
дзен: дзен
дзеневакансиидзен: дзеневакансиидзен
добавить: добавит
добавление: добавление
документ: документы
долгожданный: долгожданного
дополнение: дополнение дополнения
доступный: доступен доступна
друг: другом друзей
другой: другая
жанр: жанре
ждать: ждет
завидовать: завидовать
загадочный: загадочная
игра: игра играми игру игры
играбельный: играбельных
игрепоклонник: игрепоклонникам
игровой: игровом игровые
игрок: игроки
империя: империя
интересный: интересного интересные
интересуютсяследить: интересуютсяследить
искусство: искусстве
история: история
итог: итоге
казаться: кажутся
канал: канал
карате: карате
карта: карт
квест: квест
комментарий: комментарий
комментироватьпока: комментироватьпока
контакт: контакты
контент: контент
который: которые который которых
кража: кражи
красивость: красивости
красивый: красивая
культовый: культовой
лишиться: лишились
мастерство: мастерстве
месяц: месяца месяцы
меч: мечом
минстудия: минстудия
минутдейля: минутдейли
мир: мир
млн: млн
многопользовательский: многопользовательские
мочь: могла
навык: навыков
навыкисравнимый: навыкисравним
награда: наград
назадподписатьсяистория: назадподписатьсяистория
назадподписатьсяспустя: назадподписатьсяспустя
название: названием
найти: найти
натура: натура
начать: начал
наш: наших
невероятный: невероятной невероятный
непередаваемый: непередаваемый
непредсказуемый: непредсказуемый
непростой: непростой
новый: новые новых
номинация: номинации
оба: обе
обладать: обладающий
обычный: обычным
огонь: огнем
один: одна одну
ожидаться: ожидается
они: ними
оно: оно
опасный: опасный
отказаться: отказался
открыть: открыли
отставать: отставая
очень: очень
первымрекомендовать: первымрекомендуем
персонаж: персонажей
победа: победа
подождать: подождать
подписчикаподписатьсябесплатный: подписчикаподписатьсябесплатное
поколение: поколения
породить: породила
последний: последнее последнем
потерять: потеряли
похожий: похожие
пощеголять: пощеголять
правда: правда
право: прав
превзойти: превзойти
прийтись: придется
произведение: произведение
происходить: происходят
пройти: прошли
пропустить: пропустите пропустить
прославиться: прославилась
противник: противников
прошлый: прошлом
публикациина: публикациине
путь: пути путь
различие: различия
разобрать: разобрать
разрушительный: разрушительными
расширение: расширения
релиз: релиза релизе
рисовать: рисованная
ролевый: ролевая ролевой
свой: своем своё
серия: серии
сила: силой
система: системы
сказать: сказать
слух: слухи
событие: события
современный: современной
соединить: соединил
создать: создав
солдат: солдат
соперник: соперник
сосецукен: сосецукен сосецукеном
сосредоточиться: сосредоточилась
список: списком
спокойствие: спокойствием
спустя: спустя
сравнить: сравнить
средне: средне
стать: станет
стиль: стиль
страх: страх
студия: студии студию студия
счастие: счастью
также: также
такой: таких
талантливый: талантливых
темувидеостатьироликиновостивидеоигрыдетямвсё: темувидеостатьироликиновостивидеоигрыдетямвсё
темувойтиглавнаяподпискинайти: темувойтиглавнаяподпискинайти
темыстратегия: темыстратегии
тихонаписать: тихонапишите
тренироваться: тренировавшийся
три: трёх
тусовка: тусовок
тянуться: тянется
убить: убил
удар: удары
улица: улицы
уродский: уродской
успех: успех успеха
функция: функций
хороший: лучшая
хотеть: хочу
хотя: хотя
церемония: церемонии
человек: человеком
число: числе
читать: читали
шарм: шарм
эстонский: эстонская
это: это
этот: этими
являться: является
