агентный: агентными
алгоритм: алгоритмов
альтернатива: альтернативой
анонсировать: анонсированы
аппаратный: аппаратным
апрель: апреле
архитектура: архитектуре
ассортимент: ассортименте
аудиосистемыграфический: аудиосистемыграфические
батарея: батарей
большинство: большинству
бюджетный: бюджетный
важный: важного
вакансия: вакансии
вариант: варианты
ватт: ватт
вдвое: вдвое
вердикт: вердикт
версия: версия
вес: весом
весыколонка: весыколонки
взглянуть: взгляните
взять: возьмем
видеокарта: видеокарт видеокарты
визуальный: визуальными
виртуальный: виртуальных
включать: включают
включая: включая
вместо: вместо
возникнуть: возник
вопрос: вопрос
вполне: вполне
время: времени время
вторичка: вторичке
входить: входят
выгодный: выгоднее
вынести: вынесли
выполнять: выполняет
высокий: высокую
вычисление: вычисления
выше: выше
гбайт: гбайт
глобальный: глобальных
год: году лет
голова: голове
господин: господа
графический: графические графический графических
гц: гц
давно: давно
двукратный: двукратный
девятый: девятого
декодирование: декодирования
дзен: дзен
дзеневакансиидзен: дзеневакансиидзен
длинный: длинные
добрый: доброго
документ: документы
дополнить: дополненной
дополнять: дополняют
достигнуть: достигли
доступ: доступ
другой: другие других
ждать: ждут
завалиться: завалившийся
задача: задач
задумываться: задумываются
занимать: занимают
запрещать: запрещает
зафиксировать: зафиксировала
заявить: заявила
знать: знали
игровой: игровой
изображение: изображений
индустрииигра: индустрииигры
интересный: интересных
интересуютсяследить: интересуютсяследить
интерфейс: интерфейс
искать: ищете
исключая: исключая
источник: источник
ия: ии
канал: канал
карта: карты
китай: китай
книгиновинка: книгиновинки
кодирование: кодирования
кодировщик: кодировщиком
колонкиотраслевый: колонкиотраслевые
компания: компаний компания
компонент: компонентов
конец: конце концов
консолиумный: консолиумные
контакт: контакты
конфигурация: конфигурации
который: которая которой которые который
критика: критики
крупный: крупная
лето: летом
литиевый: литиевых
луна: луне
магазин: магазинах
май: мае
майнинга: майнинг
максимальный: максимальную
мало: мало
малый: меньшим
маркетинг: маркетинг маркетингом
месяц: месяца
минкомпания: минкомпания
минутгерман: минутгерман
млн: млн
многопоточный: многопоточным
мобильный: мобильные мобильных
моделирование: моделированием
модель: модели моделями
модуль: модуль
мой: моей
момент: момента
мультипроцессор: мультипроцессоры
назадподписатьсянасколько: назадподписатьсянасколько
назадподписатьсянюанс: назадподписатьсянюансы
найти: найти
настолько: настолько
настольный: настольные настольных
насчитывать: насчитывают
независимый: независимых
нейронный: нейронные
новинка: новинок
новость: новостей
новый: новой новые
ноутбук: ноутбуков
нужный: нужна
нынешний: нынешнем нынешними
обеспечивать: обеспечивает обеспечивают
обладать: обладают
обнаглеть: обнаглевшей
обработка: обработке
обычно: обычно
обычный: обычной
ограничить: ограничит
огромный: огромные
одиссей: одиссей
ожидаться: ожидаются
оптимизировать: оптимизированных
опуститься: опустились
оснастить: оснащены
остальной: остальные
отдача: отдачу
отказаться: отказаться
отличаться: отличается
отметить: отметила
охлаждение: охлаждения
оценка: оценки
очередь: очереди
память: памяти
первый: первые
переплатить: переплатить
пк: пк
плата: платы
платформа: платформой
погибнуть: погибнуть
подготовить: подготовила
поддерживать: поддерживает поддерживают
поддержка: поддержкой
подписаться: подпишитесь
позволять: позволяющую
поздний: позже
поискать: поискать
пока: пока
показать: показали
поколение: поколение поколении поколения
покупать: покупать
покупка: покупки покупкой
полный: полной
получать: получаем
получить: получим получить
польза: пользу
пользователь: пользователей
понять: поймем
пора: пора
последний: последних
посмотреть: посмотрим посмотрите
построить: построенный
поступить: поступят
потоковый: потоковые
появиться: появятся
предлагать: предлагают
предназначить: предназначены
представить: представила представлены
предыдущий: предыдущего предыдущими
прежде: прежде
преимущество: преимуществ
приемлемый: приемлемого приемлемой
прийти: пришло
применимый: применим
примерно: примерно
принести: принёс
прирост: прирост
продажа: продажу
продиктовать: продиктованы
продуктивность: продуктивность
проектирование: проектирования
производительность: производительности
производство: производства
пройти: прошел
пропускной: пропускную
пропустить: пропустите пропустить
профессиональный: профессиональные
процессор: процессор процессора процессоров процессоры
прошлый: прошлом
публикациина: публикациине
пятикратный: пятикратный
работа: работе работу
рабочий: рабочих
радиатор: радиатор
радиоастрономия: радиоастрономии
раз: раза
разделять: разделять
различный: различных
размер: размеры
разработка: разработку
разрешение: разрешением
реальность: реальностью
реконструкция: реконструкции
релиз: релиза
рендеринг: рендеринге
решение: решения
робототехника: робототехники
рост: рост
рубль: рублей
рынок: рынок
рядом: рядом
сайт: сайте
сам: сама самого
свой: своей
секунда: секунду
сервер: серверов
серверный: серверная
серия: серии
система: систем система
скромный: скромные
сложный: сложными сложных
слот: слота
совет: совет
советовать: советуют
современный: современных
способность: способность
сравнение: сравнению
среда: среде
средство: средств
станция: станций
старый: старые
стоить: стоит
столько: столько
страна: стран
сцена: сцен
сша: сша
также: также
такой: таких
текстолит: текстолит
темувидеостатьироликиновостивидеоигрыдетямвсё: темувидеостатьироликиновостивидеоигрыдетямвсё
темувойтиглавнаяподпискинайти: темувойтиглавнаяподпискинайти
темутехнология: темутехнологии
темыгаджет: темыгаджеты
тензорный: тензорных
теплопакет: теплопакет
тестирование: тестирования
технологииумный: технологииумные
технология: технологии технологию технологиям
топ: топ
топчик: топчик
тот: те
транспортный: транспортных
трескаться: трескается
триллион: триллионов
тыс: тыс
увеличивать: увеличивают
уменьшать: уменьшать
уровень: уровня
ускоритель: ускорители ускоритель
условный: условной
фотореалистичный: фотореалистичных
фототехниканаушникиэлектронный: фототехниканаушникиэлектронные
характеристика: характеристики
хороший: лучших
хотеть: хотите
хотя: хотя
цена: ценами цены
часть: части
четвёртый: четвёртое
четыре: четыре
чип: чипе
число: число
читать: читали
шейдёр: шейдеры
шестой: шестого
шутить: шучу
электроникагеймингнайти: электроникагеймингнайти
энергопотребление: энергопотреблением
эффект: эффектами
эффективность: эффективности эффективность
являться: являются
ядеро: ядеро
ядро: ядер ядрами
