белый: белой
больший: большая
большой: большой
быстро: быстро
важный: важной
вакансия: вакансии
ваш: ваш
вернуться: вернулась
весь: всей
взглянуть: взгляните
взлететь: взлетела
вниз: вниз
восток: востоку
впечатление: впечатлениями
временный: временный
встретиться: встретятся
всё: всё
выйти: вышел вышла
выложить: выложила
выступать: выступает
выход: выхода
выше: выше
геймер: геймеры
главный: главная
год: года
голос: голос
гора: гору
готовить: готовить
гриб: гриба грибов грибы
грибной: грибного
дата: дата
дебаффа: дебафф
действие: действие
делиться: делимся
день: дня
дзен: дзен
дзеневакансиидзен: дзеневакансиидзен
дикий: дикой
добыча: добычу
документ: документы
доспех: доспехи
доступно: доступно
доступный: доступнее
друг: другом
другой: другие
её: её
жанр: жанр
жара: жара
жаркий: жарких
живописный: живописные
завернуть: заверните
занавес: занавес
заодно: заодно
заранее: заранее
земля: землей
зрелищный: зрелищнее
игра: игр игра игры
игровой: игровой игровые
игрок: игрок игроков
игрыроссийский: игрыроссийские
игрыэкшн: игрыэкшн
идея: идея
иначе: иначе
ингредиент: ингредиентом
индустрииигра: индустрииигры
интересуютсяследить: интересуютсяследить
информация: информацией
исследовать: исследует
канал: канал
киберспортодиночный: киберспортодиночные
кинематографичный: кинематографичный
ключевой: ключевых
козырь: козырь
количество: количество
комментарий: комментарий
комментироватьпока: комментироватьпока
комплектующиешутерымногопользовательский: комплектующиешутерымногопользовательские
консолинайти: консолинайти
консоль: консолях
контакт: контакты
кооператив: кооператив
который: который которых
лагерь: лагерь
легендарный: легендарной
лишний: лишнее
лишь: лишь
локализация: локализация
локация: локации локаций
материал: материал материалы
место: места
механик: механиках
механика: механика
минв: минв
минутигровый: минутигровая
мир: мир мира
миссия: миссии
млн: млн
многое: многом
монстр: монстрами монстрах монстров
назадподписатьсядикать: назадподписатьсядикая
назадподписатьсяпроща: назадподписатьсяпроще
найти: найти
напиток: напитка напитки напитков
направо: направо
например: например
наш: нашем
негативный: негативных
недалеко: недалеко
неделя: недели
недовольный: недовольны
неловкий: неловкое
неприятный: неприятный
несмотря: несмотря
неудивительный: неудивительно
нефтяной: нефтяной
нижний: нижние
низина: низине
новинка: новинку
новый: новые новый
нужно: нужно
нужный: нужный
обзор: обзор
область: областях
огромный: огромные огромными
один: одном
одиночный: одиночное
онлайн: онлайну
опасный: опаснейшими
оружие: оружие
освежать: освежающего освежающие освежающих
основный: основным
остальной: остальных
ответвление: ответвлении
отзыв: отзывов отзывы
открытый: открытый
отличаться: отличаются
отправиться: отправиться
отправляться: отправляться
охота: охота охоту охоты
охотиться: охотится
охотник: охотника охотнику
первымрекомендовать: первымрекомендуем
песочный: песочном
пещера: пещеры
пк: пк
платформа: платформа
плохой: плохие
погибнуть: погибших
подарить: подарила
подписчиковподписатьсягда: подписчиковподписатьсягде
позволять: позволяет
поиграть: поиграли
покорять: покоряет
положение: положение
получать: получать
получить: получила получит
попасть: попасть
портал: портал
поставить: поставить
предшественник: предшественник
приготовление: приготовления
приключение: приключения
продажа: продажа продажи
продолжение: продолжение
пропустить: пропустите пропустить
простой: проста
прохождение: прохождение
публикациина: публикациине
путь: пути
разворачиваться: разворачивается
разобраться: разберемся
разрывать: разрывает
рамблер: рамблер
рассказать: рассказал рассказали
рассказывать: рассказываем
расти: растут
регион: региона регионе
релиз: релиз
релизный: релизный
ролевый: ролевые
роль: роли
рпг: рпг
ругать: ругают
русский: русский
рф: рф
сайт: сайте
самый: самый
свой: своими свой
серия: серии
симулятор: симулятор симуляторы
скверный: скверное
следовать: следуйте
сложный: сложные
служить: служат
собирать: собирать
составлять: составляющей
состояние: состояние
специальный: специальные
сражаться: сражается
сражение: сражения
сразу: сразу
становиться: становится
стать: станет
столь: столь
сторона: сторону
стратегия: стратегии
существо: существами
сюжет: сюжете
также: также
текст: текст тексте
тема: темой
температура: температура
темувидеостатьироликиновостивидеоигрыдетямвсё: темувидеостатьироликиновостивидеоигрыдетямвсё
темувойтиглавнаяподпискинайти: темувойтиглавнаяподпискинайти
темуновинка: темуновинки
темыгеймингигровый: темыгеймингигровые
технический: техническое технической
течение: течению
тихонаписать: тихонапишите
тот: тому
точнее: точнее
трейлер: трейлер
тыс: тыс
убрать: убрала
улучшать: улучшать
урон: урон
фанат: фанатам
фармитя: фармить
февраль: февраля
холодное: холодные
холодный: холодных
хороший: лучшие
часть: части часть
читать: читали
чудовище: чудовищ
шляпка: шляпкой
шторм: шторме
экстремальный: экстремального
экшен: экшен
эпичный: эпичную
