аава: аава
аккуратный: аккуратны
аксессуар: аксессуары
альпинист: альпиниста
анонсировать: анонсировала
база: базе
байкальский: байкальской
бахнуть: бахнем
безопасность: безопасности
бешеный: бешеный
будущее: будущего
быть: будьте
вакансия: вакансии
ваш: ваш
вверх: вверх
вершина: вершины
взглянуть: взгляните
взлом: взлом
взломать: взломать
видео: видео
видеоигра: видеоигры
вновь: вновь
водичка: водички
войти: войти
восхождение: восхождение
всё: всё
вчера: вчера
выбрать: выбрать
выдавать: выдаёт
выживание: выживания
выжить: выжить
выйти: вышедшая
выход: выход выхода выходе
гейминг: гейминг
герой: героем
гигантский: гигантской
главный: главная главным
год: год года году
горный: горных
горо: горо
готовый: готова
группировка: группировок
далёкий: далёкого
данные: данных
действие: действие
день: день дней
дзен: дзен дзене
документ: документы
долгожданный: долгожданный
доступ: доступ
доступный: доступна
ещё: ещё
её: её
завершить: завершить
задача: задача
запланировать: запланирован
захватывать: захватывающими
защитить: защитить
зло: зла
знаменитый: знаменитый
игра: игра игре игры
игровой: игровой игровые
игрок: игроков
идеально: идеально
известный: известной
индустрия: индустрии
интересоваться: интересуются
интуитивный: интуитивный
информация: информации
искать: искать
источник: источником
каждый: каждый
канал: канал
карабкаться: карабкаться
качество: качество
киберспорт: киберспорт
колонка: колонка
комментарий: комментарии комментарий
комментировать: комментировать
компания: компании
комплектующие: комплектующие
консоль: консолей консоли
контакт: контакты
кооперативный: кооперативного
коробка: коробки
корпорация: корпорации
который: котором которые которых
маджим: маджима
март: марта
маршрут: маршрут
месяц: месяцев
мина: мин
минута: минут минуты
мир: мире
млн: млн
многопользовательский: многопользовательские
мобильный: мобильные
мы: нам
назад: назад
найти: найти
написать: напишите
настольный: настольная настольными
начинаться: начинается
наш: наши
несгибаемый: несгибаемым
новинка: новинка новинки
новость: новости
новый: новой новые новый новыми
обзавестись: обзавелись
обзор: обзор обзоре обзоры
обладать: обладает
объявить: объявили
один: одного
одиночный: одиночные
окаянный: окаянных
около: около
окончание: окончания
опора: опоры
опубликовать: опубликовала
оригинальный: оригинальной
основной: основной
ответвление: ответвлением
отправиться: отправится
пара: пару
первый: первая первым первых
перечень: перечень
персонаж: персонажей
перун: перуна
планировать: планируйте
плохо: плохо
погнать: погнали
подписаться: подписаться подпишитесь
подписка: подписки
подписчик: подписчиков
подряд: подряд
подходить: подходит
пожертвовать: пожертвовать
пока: пока
покорять: покорять
полтора: полтора
получить: получить
помнить: помните
помощь: помощью
попробовать: попробуем
поражать: поражает
почитать: почитать
правильно: правильно
предстоять: предстоит
предыдущий: предыдущие
прийтись: придётся
приквел: приквелом
приключение: приключения
продуманность: продуманность
проект: проектами
пропустить: пропустите пропустить
простой: простого
против: против
прошлогодний: прошлогодней
публикация: публикации
пытаться: пытаются
пёс: пёс
равновесие: равновесие
разворачиваться: разворачивается
различный: различных
разобраться: разобраться
разработчик: разработчики разработчиков
ранее: ранее
рассчитывать: рассчитывайте
ребёнок: детям
рекомендовать: рекомендуем
релиз: релиз
ресурс: ресурсы
родина: родину
роза: роза
ролевый: ролевые
ролик: ролики
российский: российские
русама: русам
русый: русы
свежий: свежее свежую
свой: своими свой своё
связь: связи
секретный: секретной
секунда: секунд
сервер: серверы
серия: серии
сиквел: сиквеле
сила: силы
симулятор: симулятор симулятора симуляторы
скалолазание: скалолазания
скорость: скорости
следить: следить
слэшер: слэшер
создатель: создателей
сообщить: сообщили
сорваться: сорваться
соревноваться: соревноваться
состояться: состоится
способность: способностями
спустя: спустя
становиться: становится
стать: став станет
статья: статьи
стратегия: стратегии
студия: студия
суровый: суровых
суть: сути
также: также
такой: такими
творение: творение
тема: темой тему темы
техника: технике
технология: технологиями
тихо: тихо
точка: точки
трейлер: трейлер
третий: третий
треш: треш
удерживать: удерживайте
узнать: узнайте
уникальный: уникальными
упаковка: упаковки
управление: управления
условие: условиях
уточняться: уточнялся
хакер: хакеры
хранение: хранения
часть: части
четыре: четырёх
чёрный: чёрная
шутеры: шутеры
экономить: экономьте
экшен: экшена
экшн: экшн
элемент: элементами
это: это
являться: является
ящер: ящеров
