автопилот: автопилоте
анонс: анонс анонса анонсом
анонсировать: анонсировала анонсировали
близкий: ближайшее
вакансия: вакансии
ведущий: ведущие
вернуться: вернуться
весь: всей всем всему
взгляд: взгляд
взглянуть: взгляните
взламывать: взламывать
видео: видео
видеоигра: видеоигры
виновник: виновник
возродить: возродить
войти: войти
волнение: волнение
воспоминание: воспоминания
воссоздать: воссоздать
восторг: восторге
время: время
вроде: вроде
встретить: встретил
встреча: встреча
всё: всё
выглядеть: выглядит
выделяться: выделяется
выйти: вышли
выпускать: выпускает выпускать
выше: выше
гвоздь: гвоздь
гейминг: гейминг
геймплей: геймплея
геймплейный: геймплейному
геншина: геншин
герман: герман
герой: героя
главное: главного
главный: главная главную
год: год года
готовиться: готовится
готовый: готовы
гроб: гроб
группа: группа
далее: далее
двухминутный: двухминутному
день: дня
детский: детские
дзен: дзен дзене
дизлайк: дизлайка
добраться: добрался
документ: документы
дополнительный: дополнительными
дорога: дороги
достойный: достойными
доступ: доступа
единственный: единственная
ещё: ещё
её: её
жанр: жанра жанре
забить: забила
закалить: закалили
запуск: запуску
зарядка: зарядка
игра: игр игра игры
игровой: игровой игровые игровых
игрок: игроков
издательство: издательства
изнывать: изнывают
изображение: изображением изображений изображения
именно: именно
индустрия: индустрии
интересный: интересных
интересоваться: интересуются
использование: использованием
история: истории
источник: источник
исходный: исходного
казаться: казался
канал: канал
классический: классического
км: км
код: кода
количество: количество
команда: команда команду
комментарий: комментариям
комплект: комплекта
консоль: консолей консоли
контакт: контакты
который: которого которые который
крейн: крейн
крупный: крупные
культовый: культового
лайковый: лайков
любимый: любимым
май: мая
материал: материалов
месяц: месяцев
мина: мин
минута: минут минуты
мир: миру
млн: млн
мода: мод мода
моддёр: моддеров
модификация: модификация
мой: мое мои моим
момент: момент
мочь: могу
мультиплеерный: мультиплеерного
назад: назад
назвать: назвать
найти: найти
научиться: научились
нацелить: нацелена
наш: наш
нашуметь: нашумевшим
невероятно: невероятно
некоторый: некоторые
несколько: несколькими
несмотря: несмотря
нетерпение: нетерпения
новинка: новинки
новость: новостей новости
новый: новые новый новых
нуль: нуля
обещать: обещают
объединиться: объединившаяся
обычно: обычно
огромный: огромное
один: одними
однако: однако
ожидать: ожидаемых
ожидаться: ожидается
оригинальный: оригинального
основа: основе
оставаться: оставаться
остаться: остались
остров: остров
ответ: ответа ответе
отметить: отметить
оценить: оценить
очаровательно: очаровательно
ощущение: ощущение ощущения
первый: первый
передать: передаст
переносить: переносили
переписать: переписанными
переходить: переходить
песочница: песочниц
платформа: платформы
племя: племенем
поверить: поверить
поддерживать: поддерживать
поделиться: поделился поделятся
подписаться: подписаться подпишитесь
подписка: подписки
подписчик: подписчиков
подробность: подробностями
подтвердить: подтвердить
пожалуй: пожалуй
позиционироваться: позиционируется
полноценный: полноценный
получить: получил получило
пользователь: пользователи
помощь: помощью
популярный: популярными
попытка: попытка
посвятить: посвященный
последний: последнее последние последний
построить: построена
почитать: почитать
появление: появление
практически: практически
предложить: предложит
представитель: представителями
презентация: презентации
привет: привет
привлекательный: привлекательным
прикрепить: прикреплён
прилавок: прилавков
пробег: пробега
проблема: проблему
продолжать: продолжают
пропустить: пропустите пропустить
протаранить: протаранила
против: против
протяжение: протяжении
прошлое: прошлое
публикация: публикации
пустой: пустой
различный: различными
разочарование: разочарованием
разработка: разработки
разработчик: разработчики
ракьят: ракьят
ранний: раннего
рановато: рановато
рассмотреть: рассмотрим
ребёнок: детям
рекомендовать: рекомендуем
релиз: релиз
ремейк: ремейк ремейка
рендерер: рендерером
решить: решила
ролик: ролик ролики
сайт: сайте
самостоятельный: самостоятельная
самый: самое самым самых
связаться: связался
сделать: сделав
серия: серии
сильный: сильнее
система: системами
следить: следить
смело: смело
событие: событиями
современный: современные
солнечный: солнечный
сопровождать: сопровождавшему
сопровождаться: сопровождается
сохранить: сохранив
списывать: списывать
сразу: сразу
среди: среди
старание: старания
старт: старт
стать: стал
статья: статье статьи
стена: стену
стоить: стоит
судить: судя
считаться: считались
счёт: счетов
также: также
телеграмма: телеграмм
тема: темой тему темы
технический: технические
типичный: типичных
трагический: трагическими
трейлер: трейлеру
третий: третий
тыс: тыс
тёплый: теплый
убитый: убита
удовлетворить: удовлетворить
улучшение: улучшения
усовершенствование: усовершенствования
фанат: фанатов
февраль: феврале
фон: фоне
хороший: лучших
час: часов
часть: части
читать: читали
шейдёр: шейдерами
шутер: шутера шутеров
шутеры: шутеры
экшен: экшен
электромобиль: электромобилей
элемент: элементы
энергия: энергию
это: это
яркий: яркий
