адепт: адепты
бакс: баксов
банковский: банковские
блок: блок
больший: большие
братик: братик
быстрый: быстрой
вакансия: вакансии
вариант: вариант
версия: версию версия
взглянуть: взгляните
видеокарта: видеокарт видеокарте видеокартой видеокарты
визуальный: визуальными
воображение: воображение
восьмиядерник: восьмиядерник
встречаться: встречаются
всё: всё
вы: вами
вывалить: вывалив
выгодный: выгодные
выйти: выйдет
высокопроизводительный: высокопроизводительный
гб: гб
главный: главной
год: году
грамотность: грамотности
графика: графики
графикипрактически: графикипрактически
графический: графические
давать: дают
дать: данная
два: двух
демонстрационный: демонстрационную
дефицит: дефицит
дзен: дзен
дзеневакансиидзен: дзеневакансиидзен
документ: документы
доллар: долларов
доступ: доступ
ещё: ещё
заиграть: заиграла
заказ: заказ
запуск: запуска
затея: затея
значительно: значительно
игровой: игровой
избранный: избранных
инсайдер: инсайдеры
интересуютсяследить: интересуютсяследить
использование: использованием
каждый: каждый
канал: канал
килобайт: килобайт
ключевой: ключевые
количество: количество
комплектующие: комплектующие
компьютер: компьютер
контакт: контакты
контроллер: контроллер
который: которая которому которых
краска: красками
крупный: крупные
крутой: крутой
кто: кого
культовый: культового
кусаться: кусаются
кэш: кэш кэша
лежать: лежат
лиза: лиза
лицо: лице
локация: локации
луч: лучей
любой: любые
магазин: магазины
майнер: майнеры
максимальный: максимальных
менять: меняет
месяц: месяц
мечтать: мечтает
микроархитектура: микроархитектуре
минстудия: минстудия
млн: млн
модель: моделями
мочь: могут
мощный: мощный
назадподписатьсяобзор: назадподписатьсяобзор
назадподписатьсясобирать: назадподписатьсясобираем
найти: найти
накинуть: накинула
нанометровый: нанометровом
например: например
настольный: настольной
настройка: настройках
неделя: неделю
недоступный: недоступна
неофициальный: неофициальный
нескоро: нескоро
новый: нова нового новой новом новые новыми
нужный: нужен
обновить: обновлённый
обычно: обычно
однако: однако
около: около
оно: оно
оперативный: оперативной
опробовать: опробовать
оригинальный: оригинальная
освещение: освещение
основный: основными
особенность: особенностью
остаться: остались
ответственно: ответственно
отзыв: отзывов
открыть: открыты
отличаться: отличается
отличие: отличиями
относиться: относится
очень: очень
память: памяти
партия: партии
первый: первые
петь: пели
пк: пк
планета: планете
поддержка: поддержке
подождать: подождать
позволять: позволяют
показаться: показаться
поколение: поколений поколения
полный: полная
положительный: положительные
получить: получить
понятно: понятно
поражать: поражают
последний: последних
потенциал: потенциал
потребоваться: потребуется
похожий: похож
править: правит
предложение: предложения
представить: представила
прежний: прежними
прибыть: прибудут
прийти: пришёл
прийтись: придётся
прилавок: прилавках прилавков
приобрести: приобрети
прогноз: прогнозы
продукт: продукты
пропустить: пропустите пропустить
проспект: проспект
противоречивый: противоречивые
процессор: процессор процессоров процессором
публикациина: публикациине
р: р
рабочий: рабочий
разрешение: разрешения
расширить: расширить
рейвенхольм: рейвенхольм
рекомендовать: рекомендованная
релиз: релиза
ремастер: ремастер
российский: российских
рубль: рублей
сам: самой
самый: самые самый
сборка: сборке
свой: свой
сегмент: сегментом
сегодня: сегодня
сильно: сильно
скриншот: скриншот
слабый: слабее
слово: словах
сметать: сметали
собрать: собрала собрать
современный: современные
создать: созданный
сравнение: сравнение
стать: стала
су: су
сутки: сутки
существенный: существеннее
сша: сша
таблица: таблица
таки: таки
такой: такие такого
твой: твой
текстура: текстурами
темувидеостатьироликиновостивидеоигрыдетямвсё: темувидеостатьироликиновостивидеоигрыдетямвсё
темувойтиглавнаяподпискинайти: темувойтиглавнаяподпискинайти
темышутерыгеймингнайти: темышутерыгеймингнайти
тест: тесты
технология: технологий
техпроцесс: техпроцессе
топовый: топовые топовый
тот: тех
трассировка: трассировка
тыс: тыс
тысяча: тысяч
удел: уделом
указывать: указывая
улучшить: улучшенными
финансовый: финансовой
флагман: флагманом
хотя: хотя
хт: хт
целый: целых
цена: цена цены
частота: частоты
череда: черёд
четыре: четырех
чип: чипы
читать: читали
шутер: шутера
электроникатехнология: электроникатехнологии
энтузиаст: энтузиастами
эффект: эффектами
являться: является
ядро: ядер
