автор: авторов
альтернативный: альтернативной
английский: английской
арена: арене
аудитория: аудитория
базироваться: базировались
батарея: батарей
безумный: безумные
библиотека: библиотеке
битва: битвы
благодаря: благодаря
важный: важной
вакансия: вакансии
варьироваться: варьируются
вдвое: вдвое
великий: великие
взглянуть: взгляните
видео: видео
видеоигра: видеоигр видеоигры
включая: включая
внезапно: внезапно
вовсе: вовсе
война: войны
войти: войти
волна: волну
восемь: восемь
время: времен
всё: всё
второй: второй вторую
выбывание: выбывание
выглядеть: выглядит
выдающийся: выдающихся
выживание: выживания
выйти: вышли
выпустить: выпустила
выход: выход
выходка: выходок
гейминг: гейминг
германия: германии
герой: героев
главный: главная
год: год году
граница: границей
графика: графика графикой
громкий: громкие
два: две двумя
движок: движке
дейли: дейли
делать: делала
демонстрация: демонстрации
день: дня
десятилетие: десятилетия
дзен: дзен дзене
днайва: днайв
документ: документы
доступ: доступ
доступный: доступна
дрессировка: дрессировкой
друг: другом
другой: другая других
ещё: ещё
жестокость: жестокости
завалиться: завалившийся
завтра: завтра
закрытие: закрытие
замедление: замедления
запомниться: запомнится
запрет: запрет запретом
запретить: запрещены
знакомый: знакомой
игра: игр игра играми игры
игровой: игровая игровой игровом игровых
известный: известная известных
издательство: издательство
изображение: изображением изображений
индустрия: индустрии
интересный: интересных
интересоваться: интересуются
история: истории
источник: источник
канал: канал
касаться: касается
каталог: каталог каталоге
катастрофа: катастрофа катастрофу
категорический: категорический
китай: китай
классический: классических
классный: классными
компонент: компонентов
конец: конце
консоль: консолях
контакт: контакты
кооперативный: кооперативный
который: которая которые который
красивость: красивости
красивый: красивая
кроме: кроме
культурный: культурного
ландшафт: ландшафта
литиевый: литиевых
луна: луне
март: марта
мартовский: мартовских
материал: материале
международный: международной
месяц: месяца месяцев
метроидвания: метроидванией
меч: мечом
мина: мин
минута: минут минуты
мир: мира
мировой: мировой
млн: млн
многий: многих
многострадальный: многострадальной
модуль: модуль
момент: моментов
монстр: монстров
моральный: моральных
мочь: могла
мы: нам
навык: навыки навыков
назад: назад
название: названием
найти: найти
напомнить: напомнила
нацистский: нацистской
начало: начала
начаться: начался
наш: наших
недоступный: недоступны
некоторый: некоторые
непередаваемый: непередаваемый
несмотря: несмотря
новинка: новинок
новость: новостей новости
новый: новые
оба: обе
облачный: облачные
обучение: обучение
огонь: огнем
ограничить: ограничит
один: одна
одиссей: одиссей
однако: однако
одновременно: одновременно
оказаться: оказались
он: нему
отказаться: отказаться
официальный: официальным
очень: очень
пк: пк
погибнуть: погибнуть
подписаться: подписаться подпишитесь
подписка: подписки подписку
подписчик: подписчиков
поезд: поездов
покидать: покидающих
покинутый: покинут
поколение: поколения
политический: политических
получить: получили
польза: пользу
пополнить: пополнит
популярность: популярность
последний: последние
поступок: поступки
постъядерный: постъядерный
похожий: похожие
почему: почему
почитать: почитать
пощеголять: пощеголять
появиться: появился появится появятся
правда: правда
предложение: предложения
представить: представило
прежде: прежде
приключение: приключение приключением
принести: принёс
присоединиться: присоединится присоединятся
причина: причины
программа: программы
проект: проекта проектов
производство: производства
пропустить: пропустите пропустить
прошлый: прошлом
публикация: публикации
радиоастрономия: радиоастрономии
различие: различия
различный: различных
разобрать: разобрать
разработчик: разработчиков
рамка: рамках
раскрыть: раскрыло
распространение: распространение
рассмотреть: рассмотрим
расширить: расширит
ребёнок: детям
рекомендовать: рекомендуем
релиз: релизом
решить: решила
рисовать: рисованная
роглайк: роглайк
ролевый: ролевая ролевой ролевые
ролик: ролики
россия: россии
рф: рф
рядом: рядом
сайт: сайте
самый: самые
сборник: сборник
свой: своим
сегодняшний: сегодняшнего
сервис: сервис
сервисный: сервисную
серия: серия
символика: символики
симулятор: симулятор
система: системы
сказать: сказать
скандал: скандалы
скоро: скоро
следить: следить
современный: современной
сократиться: сократилась
список: список
сравнимый: сравним
сравнить: сравнить
сразу: сразу
стать: стали
статья: статье статьи
стезя: стези
столкнуться: столкнулась
страна: стран странах
стратегия: стратегии
студия: студии студий
супергеройский: супергеройским
сша: сша
сюжетный: сюжетных
также: также
тема: темой тему темы
технология: технологиям
традиционно: традиционно
три: тремя
тыс: тыс
тянуться: тянется
уголок: уголках
удалить: удалят
ударно: ударно
уродский: уродской
уходить: уходящий
фэнтезийный: фэнтезийная
хотеть: хочу
хотя: хотя
часть: частью
человек: человека
четыре: четыре
читать: читали
чрезмерный: чрезмерной
шарм: шарм
экшен: экшен экшеном
элемент: элементами
это: это
этот: этими
